season,League_name,team_long_name_x,W,D,L,GF,GA,Pts,GD
2008/2009,Belgium Jupiler League,Beerschot AC,11,9,14,44,42,42,2
2008/2009,Belgium Jupiler League,Club Brugge KV,18,5,11,59,50,59,9
2008/2009,Belgium Jupiler League,FCV Dender EH,9,8,17,44,58,35,-14
2008/2009,Belgium Jupiler League,KAA Gent,17,8,9,67,42,59,25
2008/2009,Belgium Jupiler League,KRC Genk,15,5,14,48,51,50,-3
2008/2009,Belgium Jupiler League,KSV Cercle Brugge,14,5,15,48,53,47,-5
2008/2009,Belgium Jupiler League,KSV Roeselare,8,6,20,33,59,30,-26
2008/2009,Belgium Jupiler League,KV Kortrijk,9,11,14,37,55,38,-18
2008/2009,Belgium Jupiler League,KV Mechelen,12,10,12,46,52,46,-6
2008/2009,Belgium Jupiler League,KVC Westerlo,15,7,12,42,38,52,4
2008/2009,Belgium Jupiler League,RAEC Mons,3,10,21,31,57,19,-26
2008/2009,Belgium Jupiler League,RSC Anderlecht,24,5,5,75,30,77,45
2008/2009,Belgium Jupiler League,Royal Excel Mouscron,12,8,14,42,49,44,-7
2008/2009,Belgium Jupiler League,SV Zulte-Waregem,16,7,11,55,36,55,19
2008/2009,Belgium Jupiler League,Sporting Charleroi,12,7,15,43,48,43,-5
2008/2009,Belgium Jupiler League,Sporting Lokeren,13,12,9,40,32,51,8
2008/2009,Belgium Jupiler League,Standard de Liège,24,5,5,66,26,77,40
2008/2009,Belgium Jupiler League,Tubize,7,6,21,35,77,27,-42
2008/2009,England Premier League,Arsenal,20,12,6,68,37,72,31
2008/2009,England Premier League,Aston Villa,17,11,10,54,48,62,6
2008/2009,England Premier League,Blackburn Rovers,10,11,17,40,60,41,-20
2008/2009,England Premier League,Bolton Wanderers,11,8,19,41,53,41,-12
2008/2009,England Premier League,Chelsea,25,8,5,68,24,83,44
2008/2009,England Premier League,Everton,17,12,9,55,37,63,18
2008/2009,England Premier League,Fulham,14,11,13,39,34,53,5
2008/2009,England Premier League,Hull City,8,11,19,39,64,35,-25
2008/2009,England Premier League,Liverpool,25,11,2,77,27,86,50
2008/2009,England Premier League,Manchester City,15,5,18,58,50,50,8
2008/2009,England Premier League,Manchester United,28,6,4,68,24,90,44
2008/2009,England Premier League,Middlesbrough,7,11,20,28,57,32,-29
2008/2009,England Premier League,Newcastle United,7,13,18,40,59,34,-19
2008/2009,England Premier League,Portsmouth,10,11,17,38,57,41,-19
2008/2009,England Premier League,Stoke City,12,9,17,38,55,45,-17
2008/2009,England Premier League,Sunderland,9,9,20,34,54,36,-20
2008/2009,England Premier League,Tottenham Hotspur,14,9,15,45,45,51,0
2008/2009,England Premier League,West Bromwich Albion,8,8,22,36,67,32,-31
2008/2009,England Premier League,West Ham United,14,9,15,42,45,51,-3
2008/2009,England Premier League,Wigan Athletic,12,9,17,34,45,45,-11
2008/2009,France Ligue 1,AJ Auxerre,16,7,15,35,35,55,0
2008/2009,France Ligue 1,AS Monaco,11,12,15,41,45,45,-4
2008/2009,France Ligue 1,AS Nancy-Lorraine,10,12,16,38,47,42,-9
2008/2009,France Ligue 1,AS Saint-Étienne,11,7,20,40,56,40,-16
2008/2009,France Ligue 1,FC Lorient,10,15,13,47,47,45,0
2008/2009,France Ligue 1,FC Nantes,9,10,19,33,54,37,-21
2008/2009,France Ligue 1,FC Sochaux-Montbéliard,10,12,16,40,48,42,-8
2008/2009,France Ligue 1,Girondins de Bordeaux,24,8,6,64,34,80,30
2008/2009,France Ligue 1,Grenoble Foot 38,10,14,14,24,37,44,-13
2008/2009,France Ligue 1,LOSC Lille,17,13,8,51,39,64,12
2008/2009,France Ligue 1,Le Havre AC,7,5,26,30,67,26,-37
2008/2009,France Ligue 1,Le Mans FC,10,10,18,43,54,40,-11
2008/2009,France Ligue 1,OGC Nice,13,11,14,40,41,50,-1
2008/2009,France Ligue 1,Olympique Lyonnais,20,11,7,52,29,71,23
2008/2009,France Ligue 1,Olympique de Marseille,22,11,5,67,35,77,32
2008/2009,France Ligue 1,Paris Saint-Germain,19,7,12,49,38,64,11
2008/2009,France Ligue 1,SM Caen,8,13,17,42,49,37,-7
2008/2009,France Ligue 1,Stade Rennais FC,15,16,7,42,34,61,8
2008/2009,France Ligue 1,Toulouse FC,16,16,6,45,27,64,18
2008/2009,France Ligue 1,Valenciennes FC,10,14,14,35,42,44,-7
2008/2009,Germany 1. Bundesliga,1. FC Köln,11,6,17,35,50,39,-15
2008/2009,Germany 1. Bundesliga,Bayer 04 Leverkusen,14,7,13,59,46,49,13
2008/2009,Germany 1. Bundesliga,Borussia Dortmund,15,14,5,60,37,59,23
2008/2009,Germany 1. Bundesliga,Borussia Mönchengladbach,8,7,19,39,62,31,-23
2008/2009,Germany 1. Bundesliga,DSC Arminia Bielefeld,4,16,14,29,56,28,-27
2008/2009,Germany 1. Bundesliga,Eintracht Frankfurt,8,9,17,39,60,33,-21
2008/2009,Germany 1. Bundesliga,FC Bayern Munich,20,7,7,71,42,67,29
2008/2009,Germany 1. Bundesliga,FC Energie Cottbus,8,6,20,30,57,30,-27
2008/2009,Germany 1. Bundesliga,FC Schalke 04,14,8,12,47,35,50,12
2008/2009,Germany 1. Bundesliga,Hamburger SV,19,4,11,49,47,61,2
2008/2009,Germany 1. Bundesliga,Hannover 96,10,10,14,49,69,40,-20
2008/2009,Germany 1. Bundesliga,Hertha BSC Berlin,19,6,9,48,41,63,7
2008/2009,Germany 1. Bundesliga,Karlsruher SC,8,5,21,30,54,29,-24
2008/2009,Germany 1. Bundesliga,SV Werder Bremen,12,9,13,64,50,45,14
2008/2009,Germany 1. Bundesliga,TSG 1899 Hoffenheim,15,10,9,63,49,55,14
2008/2009,Germany 1. Bundesliga,VfB Stuttgart,19,7,8,63,43,64,20
2008/2009,Germany 1. Bundesliga,VfL Bochum,7,11,16,39,55,32,-16
2008/2009,Germany 1. Bundesliga,VfL Wolfsburg,21,6,7,80,41,69,39
2008/2009,Italy Serie A,Atalanta,13,8,17,45,48,47,-3
2008/2009,Italy Serie A,Bologna,9,10,19,43,62,37,-19
2008/2009,Italy Serie A,Cagliari,15,8,15,49,50,53,-1
2008/2009,Italy Serie A,Catania,12,7,19,41,51,43,-10
2008/2009,Italy Serie A,Chievo Verona,8,14,16,35,49,38,-14
2008/2009,Italy Serie A,Fiorentina,21,5,12,53,38,68,15
2008/2009,Italy Serie A,Genoa,19,11,8,56,39,68,17
2008/2009,Italy Serie A,Inter,25,9,4,70,32,84,38
2008/2009,Italy Serie A,Juventus,21,11,6,69,37,74,32
2008/2009,Italy Serie A,Lazio,15,5,18,46,55,50,-9
2008/2009,Italy Serie A,Lecce,5,15,18,37,67,30,-30
2008/2009,Italy Serie A,Milan,22,8,8,70,35,74,35
2008/2009,Italy Serie A,Napoli,12,10,16,43,45,46,-2
2008/2009,Italy Serie A,Palermo,17,6,15,57,50,57,7
2008/2009,Italy Serie A,Reggio Calabria,6,13,19,30,62,31,-32
2008/2009,Italy Serie A,Roma,18,9,11,64,61,63,3
2008/2009,Italy Serie A,Sampdoria,11,13,14,49,52,46,-3
2008/2009,Italy Serie A,Siena,12,8,18,33,44,44,-11
2008/2009,Italy Serie A,Torino,8,10,20,37,61,34,-24
2008/2009,Italy Serie A,Udinese,16,10,12,61,50,58,11
2008/2009,Netherlands Eredivisie,ADO Den Haag,8,8,18,41,58,32,-17
2008/2009,Netherlands Eredivisie,AZ,25,5,4,66,22,80,44
2008/2009,Netherlands Eredivisie,Ajax,21,5,8,74,41,68,33
2008/2009,Netherlands Eredivisie,De Graafschap,7,9,18,24,58,30,-34
2008/2009,Netherlands Eredivisie,FC Groningen,17,5,12,53,36,56,17
2008/2009,Netherlands Eredivisie,FC Twente,20,9,5,62,31,69,31
2008/2009,Netherlands Eredivisie,FC Utrecht,11,11,12,41,44,44,-3
2008/2009,Netherlands Eredivisie,FC Volendam,7,8,19,38,67,29,-29
2008/2009,Netherlands Eredivisie,Feyenoord,12,9,13,54,46,45,8
2008/2009,Netherlands Eredivisie,Heracles Almelo,7,11,16,35,53,32,-18
2008/2009,Netherlands Eredivisie,N.E.C.,9,15,10,41,40,42,1
2008/2009,Netherlands Eredivisie,NAC Breda,13,6,15,44,54,45,-10
2008/2009,Netherlands Eredivisie,PSV,19,8,7,71,33,65,38
2008/2009,Netherlands Eredivisie,Roda JC Kerkrade,7,9,18,38,58,30,-20
2008/2009,Netherlands Eredivisie,SC Heerenveen,17,9,8,66,57,60,9
2008/2009,Netherlands Eredivisie,Sparta Rotterdam,9,8,17,46,66,35,-20
2008/2009,Netherlands Eredivisie,Vitesse,11,10,13,41,48,43,-7
2008/2009,Netherlands Eredivisie,Willem II,10,7,17,35,58,37,-23
2008/2009,Poland Ekstraklasa,Arka Gdynia,7,9,14,27,39,30,-12
2008/2009,Poland Ekstraklasa,Cracovia,7,9,14,24,40,30,-16
2008/2009,Poland Ekstraklasa,GKS Bełchatów,17,3,10,40,28,54,12
2008/2009,Poland Ekstraklasa,Jagiellonia Białystok,9,7,14,28,34,34,-6
2008/2009,Poland Ekstraklasa,Lech Poznań,16,11,3,51,24,59,27
2008/2009,Poland Ekstraklasa,Lechia Gdańsk,9,5,16,30,44,32,-14
2008/2009,Poland Ekstraklasa,Legia Warszawa,18,7,5,52,17,61,35
2008/2009,Poland Ekstraklasa,Odra Wodzisław,8,8,14,23,40,32,-17
2008/2009,Poland Ekstraklasa,P. Warszawa,15,9,6,40,23,54,17
2008/2009,Poland Ekstraklasa,Piast Gliwice,9,6,15,17,26,33,-9
2008/2009,Poland Ekstraklasa,Polonia Bytom,17,13,30,50,79,64,-29
2008/2009,Poland Ekstraklasa,Ruch Chorzów,9,7,14,22,32,34,-10
2008/2009,Poland Ekstraklasa,Widzew Łódź,10,5,15,27,43,35,-16
2008/2009,Poland Ekstraklasa,Wisła Kraków,19,7,4,53,21,64,32
2008/2009,Poland Ekstraklasa,Śląsk Wrocław,11,12,7,40,34,45,6
2008/2009,Portugal Liga ZON Sagres,Académica de Coimbra,10,9,11,28,32,39,-4
2008/2009,Portugal Liga ZON Sagres,Amadora,8,10,12,26,38,34,-12
2008/2009,Portugal Liga ZON Sagres,CD Nacional,15,7,8,47,32,52,15
2008/2009,Portugal Liga ZON Sagres,CF Os Belenenses,5,9,16,28,52,24,-24
2008/2009,Portugal Liga ZON Sagres,CS Marítimo,9,10,11,35,36,37,-1
2008/2009,Portugal Liga ZON Sagres,FC Paços de Ferreira,9,7,14,37,42,34,-5
2008/2009,Portugal Liga ZON Sagres,FC Porto,21,7,2,61,18,70,43
2008/2009,Portugal Liga ZON Sagres,Leixões SC,12,9,9,30,31,45,-1
2008/2009,Portugal Liga ZON Sagres,Naval 1° de Maio,7,8,15,25,39,29,-14
2008/2009,Portugal Liga ZON Sagres,Rio Ave FC,8,6,16,20,35,30,-15
2008/2009,Portugal Liga ZON Sagres,SC Braga,13,11,6,38,21,50,17
2008/2009,Portugal Liga ZON Sagres,SL Benfica,17,8,5,54,32,59,22
2008/2009,Portugal Liga ZON Sagres,Sporting CP,20,6,4,45,20,66,25
2008/2009,Portugal Liga ZON Sagres,Trofense,5,8,17,25,42,23,-17
2008/2009,Portugal Liga ZON Sagres,Vitória Guimarães,10,8,12,32,36,38,-4
2008/2009,Portugal Liga ZON Sagres,Vitória Setúbal,7,5,18,21,46,26,-25
2008/2009,Scotland Premier League,Aberdeen,14,11,13,41,40,53,1
2008/2009,Scotland Premier League,Celtic,24,10,4,80,33,82,47
2008/2009,Scotland Premier League,Dundee United,13,14,11,47,50,53,-3
2008/2009,Scotland Premier League,Falkirk,9,11,18,37,52,38,-15
2008/2009,Scotland Premier League,Hamilton Academical FC,12,5,21,30,53,41,-23
2008/2009,Scotland Premier League,Heart of Midlothian,16,11,11,40,37,59,3
2008/2009,Scotland Premier League,Hibernian,11,14,13,42,46,47,-4
2008/2009,Scotland Premier League,Inverness Caledonian Thistle,10,7,21,37,58,37,-21
2008/2009,Scotland Premier League,Kilmarnock,12,8,18,38,48,44,-10
2008/2009,Scotland Premier League,Motherwell,13,9,16,46,51,48,-5
2008/2009,Scotland Premier League,Rangers,26,8,4,77,28,86,49
2008/2009,Scotland Premier League,St. Mirren,9,10,19,33,52,37,-19
2008/2009,Spain LIGA BBVA,Athletic Club de Bilbao,12,8,18,47,62,44,-15
2008/2009,Spain LIGA BBVA,Atlético Madrid,20,7,11,80,57,67,23
2008/2009,Spain LIGA BBVA,CA Osasuna,10,13,15,41,47,43,-6
2008/2009,Spain LIGA BBVA,CD Numancia,10,5,23,38,69,35,-31
2008/2009,Spain LIGA BBVA,FC Barcelona,27,6,5,105,35,87,70
2008/2009,Spain LIGA BBVA,Getafe CF,10,12,16,50,56,42,-6
2008/2009,Spain LIGA BBVA,Málaga CF,15,10,13,55,59,55,-4
2008/2009,Spain LIGA BBVA,RC Deportivo de La Coruña,16,10,12,48,47,58,1
2008/2009,Spain LIGA BBVA,RC Recreativo,8,9,21,34,57,33,-23
2008/2009,Spain LIGA BBVA,RCD Espanyol,12,11,15,46,49,47,-3
2008/2009,Spain LIGA BBVA,RCD Mallorca,14,9,15,53,60,51,-7
2008/2009,Spain LIGA BBVA,Racing Santander,12,10,16,49,48,46,1
2008/2009,Spain LIGA BBVA,Real Betis Balompié,10,12,16,51,58,42,-7
2008/2009,Spain LIGA BBVA,Real Madrid CF,25,3,10,83,52,78,31
2008/2009,Spain LIGA BBVA,Real Sporting de Gijón,14,1,23,47,79,43,-32
2008/2009,Spain LIGA BBVA,Real Valladolid,12,7,19,46,58,43,-12
2008/2009,Spain LIGA BBVA,Sevilla FC,21,7,10,54,39,70,15
2008/2009,Spain LIGA BBVA,UD Almería,13,7,18,45,61,46,-16
2008/2009,Spain LIGA BBVA,Valencia CF,18,8,12,68,54,62,14
2008/2009,Spain LIGA BBVA,Villarreal CF,18,11,9,61,54,65,7
2008/2009,Switzerland Super League,AC Bellinzona,11,10,15,44,51,43,-7
2008/2009,Switzerland Super League,BSC Young Boys,22,7,7,85,46,73,39
2008/2009,Switzerland Super League,FC Aarau,11,11,14,35,51,44,-16
2008/2009,Switzerland Super League,FC Basel,22,6,8,72,44,72,28
2008/2009,Switzerland Super League,FC Luzern,9,8,19,45,62,35,-17
2008/2009,Switzerland Super League,FC Sion,9,10,17,44,60,37,-16
2008/2009,Switzerland Super League,FC Vaduz,5,7,24,28,85,22,-57
2008/2009,Switzerland Super League,FC Zürich,24,7,5,80,36,79,44
2008/2009,Switzerland Super League,Grasshopper Club Zürich,12,14,10,57,48,50,9
2008/2009,Switzerland Super League,Neuchâtel Xamax,10,10,16,50,57,40,-7
2009/2010,Belgium Jupiler League,Beerschot AC,9,8,11,30,43,35,-13
2009/2010,Belgium Jupiler League,Club Brugge KV,17,6,5,52,33,57,19
2009/2010,Belgium Jupiler League,KAA Gent,14,7,7,49,30,49,19
2009/2010,Belgium Jupiler League,KRC Genk,8,10,10,33,31,34,2
2009/2010,Belgium Jupiler League,KSV Cercle Brugge,11,5,12,45,40,38,5
2009/2010,Belgium Jupiler League,KSV Roeselare,4,6,18,29,58,18,-29
2009/2010,Belgium Jupiler League,KV Kortrijk,12,9,7,39,30,45,9
2009/2010,Belgium Jupiler League,KV Mechelen,12,3,13,36,46,39,-10
2009/2010,Belgium Jupiler League,KVC Westerlo,8,8,12,28,34,32,-6
2009/2010,Belgium Jupiler League,RSC Anderlecht,22,3,3,62,20,69,42
2009/2010,Belgium Jupiler League,SV Zulte-Waregem,10,11,7,39,32,41,7
2009/2010,Belgium Jupiler League,Sint-Truidense VV,12,6,10,35,35,42,0
2009/2010,Belgium Jupiler League,Sporting Charleroi,5,8,15,28,45,23,-17
2009/2010,Belgium Jupiler League,Sporting Lokeren,5,3,20,22,54,18,-32
2009/2010,Belgium Jupiler League,Standard de Liège,10,9,9,38,34,39,4
2009/2010,England Premier League,Arsenal,23,6,9,83,41,75,42
2009/2010,England Premier League,Aston Villa,17,13,8,52,39,64,13
2009/2010,England Premier League,Birmingham City,13,11,14,38,47,50,-9
2009/2010,England Premier League,Blackburn Rovers,13,11,14,41,55,50,-14
2009/2010,England Premier League,Bolton Wanderers,10,9,19,42,67,39,-25
2009/2010,England Premier League,Burnley,8,6,24,42,82,30,-40
2009/2010,England Premier League,Chelsea,27,5,6,103,32,86,71
2009/2010,England Premier League,Everton,16,13,9,60,49,61,11
2009/2010,England Premier League,Fulham,12,10,16,39,46,46,-7
2009/2010,England Premier League,Hull City,6,12,20,34,75,30,-41
2009/2010,England Premier League,Liverpool,18,9,11,61,35,63,26
2009/2010,England Premier League,Manchester City,18,13,7,73,45,67,28
2009/2010,England Premier League,Manchester United,27,4,7,86,28,85,58
2009/2010,England Premier League,Portsmouth,7,7,24,34,66,28,-32
2009/2010,England Premier League,Stoke City,11,14,13,34,48,47,-14
2009/2010,England Premier League,Sunderland,11,11,16,48,56,44,-8
2009/2010,England Premier League,Tottenham Hotspur,21,7,10,67,41,70,26
2009/2010,England Premier League,West Ham United,8,11,19,47,66,35,-19
2009/2010,England Premier League,Wigan Athletic,9,9,20,37,79,36,-42
2009/2010,England Premier League,Wolverhampton Wanderers,9,11,18,32,56,38,-24
2009/2010,France Ligue 1,AJ Auxerre,20,11,7,42,29,71,13
2009/2010,France Ligue 1,AS Monaco,15,10,13,39,45,55,-6
2009/2010,France Ligue 1,AS Nancy-Lorraine,13,9,16,46,53,48,-7
2009/2010,France Ligue 1,AS Saint-Étienne,10,10,18,27,45,40,-18
2009/2010,France Ligue 1,FC Lorient,16,10,12,54,42,58,12
2009/2010,France Ligue 1,FC Sochaux-Montbéliard,11,8,19,28,52,41,-24
2009/2010,France Ligue 1,Girondins de Bordeaux,19,7,12,58,40,64,18
2009/2010,France Ligue 1,Grenoble Foot 38,5,8,25,31,61,23,-30
2009/2010,France Ligue 1,LOSC Lille,21,7,10,72,40,70,32
2009/2010,France Ligue 1,Le Mans FC,8,8,22,36,59,32,-23
2009/2010,France Ligue 1,Montpellier Hérault SC,20,9,9,50,40,69,10
2009/2010,France Ligue 1,OGC Nice,11,11,16,41,57,44,-16
2009/2010,France Ligue 1,Olympique Lyonnais,20,12,6,64,38,72,26
2009/2010,France Ligue 1,Olympique de Marseille,23,9,6,69,36,78,33
2009/2010,France Ligue 1,Paris Saint-Germain,12,11,15,50,46,47,4
2009/2010,France Ligue 1,RC Lens,12,12,14,40,44,48,-4
2009/2010,France Ligue 1,Stade Rennais FC,14,11,13,52,41,53,11
2009/2010,France Ligue 1,Toulouse FC,12,11,15,36,36,47,0
2009/2010,France Ligue 1,US Boulogne Cote D'Opale,7,10,21,31,62,31,-31
2009/2010,France Ligue 1,Valenciennes FC,14,10,14,50,50,52,0
2009/2010,Germany 1. Bundesliga,1. FC Köln,9,11,14,33,42,38,-9
2009/2010,Germany 1. Bundesliga,1. FC Nürnberg,8,7,19,32,58,31,-26
2009/2010,Germany 1. Bundesliga,1. FSV Mainz 05,12,11,11,36,42,47,-6
2009/2010,Germany 1. Bundesliga,Bayer 04 Leverkusen,15,14,5,65,38,59,27
2009/2010,Germany 1. Bundesliga,Borussia Dortmund,16,9,9,54,42,57,12
2009/2010,Germany 1. Bundesliga,Borussia Mönchengladbach,10,9,15,43,60,39,-17
2009/2010,Germany 1. Bundesliga,Eintracht Frankfurt,12,10,12,47,54,46,-7
2009/2010,Germany 1. Bundesliga,FC Bayern Munich,20,10,4,72,31,70,41
2009/2010,Germany 1. Bundesliga,FC Schalke 04,19,8,7,53,31,65,22
2009/2010,Germany 1. Bundesliga,Hamburger SV,13,13,8,56,41,52,15
2009/2010,Germany 1. Bundesliga,Hannover 96,9,6,19,43,67,33,-24
2009/2010,Germany 1. Bundesliga,Hertha BSC Berlin,5,9,20,34,56,24,-22
2009/2010,Germany 1. Bundesliga,SC Freiburg,9,8,17,35,59,35,-24
2009/2010,Germany 1. Bundesliga,SV Werder Bremen,17,10,7,71,40,61,31
2009/2010,Germany 1. Bundesliga,TSG 1899 Hoffenheim,11,9,14,44,42,42,2
2009/2010,Germany 1. Bundesliga,VfB Stuttgart,15,10,9,51,41,55,10
2009/2010,Germany 1. Bundesliga,VfL Bochum,6,10,18,33,64,28,-31
2009/2010,Germany 1. Bundesliga,VfL Wolfsburg,14,8,12,64,58,50,6
2009/2010,Italy Serie A,Atalanta,9,8,21,37,53,35,-16
2009/2010,Italy Serie A,Bari,13,11,14,49,49,50,0
2009/2010,Italy Serie A,Bologna,10,12,16,42,55,42,-13
2009/2010,Italy Serie A,Cagliari,11,11,16,56,58,44,-2
2009/2010,Italy Serie A,Catania,10,15,13,44,45,45,-1
2009/2010,Italy Serie A,Chievo Verona,12,8,18,37,42,44,-5
2009/2010,Italy Serie A,Fiorentina,13,8,17,48,47,47,1
2009/2010,Italy Serie A,Genoa,14,9,15,57,61,51,-4
2009/2010,Italy Serie A,Inter,24,10,4,75,34,82,41
2009/2010,Italy Serie A,Juventus,16,7,15,55,56,55,-1
2009/2010,Italy Serie A,Lazio,11,13,14,39,43,46,-4
2009/2010,Italy Serie A,Livorno,7,8,23,27,61,29,-34
2009/2010,Italy Serie A,Milan,20,10,8,60,39,70,21
2009/2010,Italy Serie A,Napoli,15,14,9,50,43,59,7
2009/2010,Italy Serie A,Palermo,18,11,9,59,47,65,12
2009/2010,Italy Serie A,Parma,14,10,14,46,51,52,-5
2009/2010,Italy Serie A,Roma,24,8,6,68,41,80,27
2009/2010,Italy Serie A,Sampdoria,19,10,9,49,41,67,8
2009/2010,Italy Serie A,Siena,7,10,21,40,67,31,-27
2009/2010,Italy Serie A,Udinese,11,11,16,54,59,44,-5
2009/2010,Netherlands Eredivisie,ADO Den Haag,7,9,18,38,59,30,-21
2009/2010,Netherlands Eredivisie,AZ,19,5,10,64,34,62,30
2009/2010,Netherlands Eredivisie,Ajax,27,4,3,106,20,85,86
2009/2010,Netherlands Eredivisie,FC Groningen,14,7,13,48,47,49,1
2009/2010,Netherlands Eredivisie,FC Twente,27,5,2,63,23,86,40
2009/2010,Netherlands Eredivisie,FC Utrecht,14,11,9,39,33,53,6
2009/2010,Netherlands Eredivisie,Feyenoord,17,12,5,54,31,63,23
2009/2010,Netherlands Eredivisie,Heracles Almelo,17,5,12,54,49,56,5
2009/2010,Netherlands Eredivisie,N.E.C.,8,9,17,35,59,33,-24
2009/2010,Netherlands Eredivisie,NAC Breda,12,10,12,42,49,46,-7
2009/2010,Netherlands Eredivisie,PSV,23,9,2,72,29,78,43
2009/2010,Netherlands Eredivisie,RKC Waalwijk,5,0,29,30,80,15,-50
2009/2010,Netherlands Eredivisie,Roda JC Kerkrade,14,5,15,56,60,47,-4
2009/2010,Netherlands Eredivisie,SC Heerenveen,11,4,19,44,64,37,-20
2009/2010,Netherlands Eredivisie,Sparta Rotterdam,6,8,20,30,66,26,-36
2009/2010,Netherlands Eredivisie,VVV-Venlo,8,11,15,43,57,35,-14
2009/2010,Netherlands Eredivisie,Vitesse,8,8,18,38,62,32,-24
2009/2010,Netherlands Eredivisie,Willem II,7,2,25,36,70,23,-34
2009/2010,Poland Ekstraklasa,Arka Gdynia,7,7,16,28,39,28,-11
2009/2010,Poland Ekstraklasa,Cracovia,9,7,14,25,39,34,-14
2009/2010,Poland Ekstraklasa,GKS Bełchatów,13,9,8,37,27,48,10
2009/2010,Poland Ekstraklasa,Jagiellonia Białystok,11,11,8,29,27,44,2
2009/2010,Poland Ekstraklasa,Korona Kielce,9,10,11,35,41,37,-6
2009/2010,Poland Ekstraklasa,Lech Poznań,19,8,3,51,20,65,31
2009/2010,Poland Ekstraklasa,Lechia Gdańsk,9,10,11,30,32,37,-2
2009/2010,Poland Ekstraklasa,Legia Warszawa,15,7,8,36,22,52,14
2009/2010,Poland Ekstraklasa,Odra Wodzisław,7,6,17,27,45,27,-18
2009/2010,Poland Ekstraklasa,P. Warszawa,9,6,15,25,38,33,-13
2009/2010,Poland Ekstraklasa,Piast Gliwice,7,6,17,30,50,27,-20
2009/2010,Poland Ekstraklasa,Polonia Bytom,9,10,11,29,31,37,-2
2009/2010,Poland Ekstraklasa,Ruch Chorzów,16,5,9,40,30,53,10
2009/2010,Poland Ekstraklasa,Wisła Kraków,19,5,6,48,20,62,28
2009/2010,Poland Ekstraklasa,Zagłębie Lubin,8,11,11,30,38,35,-8
2009/2010,Poland Ekstraklasa,Śląsk Wrocław,8,12,10,32,33,36,-1
2009/2010,Portugal Liga ZON Sagres,Académica de Coimbra,8,9,13,37,42,33,-5
2009/2010,Portugal Liga ZON Sagres,CD Nacional,10,9,11,36,46,39,-10
2009/2010,Portugal Liga ZON Sagres,CF Os Belenenses,4,11,15,23,44,23,-21
2009/2010,Portugal Liga ZON Sagres,CS Marítimo,11,8,11,42,43,41,-1
2009/2010,Portugal Liga ZON Sagres,FC Paços de Ferreira,8,11,11,32,37,35,-5
2009/2010,Portugal Liga ZON Sagres,FC Porto,21,5,4,70,26,68,44
2009/2010,Portugal Liga ZON Sagres,Leixões SC,5,6,19,25,51,21,-26
2009/2010,Portugal Liga ZON Sagres,Naval 1° de Maio,10,6,14,20,35,36,-15
2009/2010,Portugal Liga ZON Sagres,Rio Ave FC,6,13,11,22,33,31,-11
2009/2010,Portugal Liga ZON Sagres,S.C. Olhanense,5,14,11,31,46,29,-15
2009/2010,Portugal Liga ZON Sagres,SC Braga,22,5,3,48,20,71,28
2009/2010,Portugal Liga ZON Sagres,SL Benfica,24,4,2,78,20,76,58
2009/2010,Portugal Liga ZON Sagres,Sporting CP,13,9,8,42,26,48,16
2009/2010,Portugal Liga ZON Sagres,"União de Leiria, SAD",9,8,13,35,41,35,-6
2009/2010,Portugal Liga ZON Sagres,Vitória Guimarães,11,8,11,31,34,41,-3
2009/2010,Portugal Liga ZON Sagres,Vitória Setúbal,5,10,15,29,57,25,-28
2009/2010,Scotland Premier League,Aberdeen,10,11,17,36,52,41,-16
2009/2010,Scotland Premier League,Celtic,25,6,7,75,39,81,36
2009/2010,Scotland Premier League,Dundee United,17,12,9,55,47,63,8
2009/2010,Scotland Premier League,Falkirk,6,13,19,31,57,31,-26
2009/2010,Scotland Premier League,Hamilton Academical FC,13,10,15,39,46,49,-7
2009/2010,Scotland Premier League,Heart of Midlothian,13,9,16,35,46,48,-11
2009/2010,Scotland Premier League,Hibernian,15,9,14,58,55,54,3
2009/2010,Scotland Premier League,Kilmarnock,8,9,21,29,51,33,-22
2009/2010,Scotland Premier League,Motherwell,13,14,11,52,54,53,-2
2009/2010,Scotland Premier League,Rangers,26,9,3,82,28,87,54
2009/2010,Scotland Premier League,St. Johnstone FC,12,11,15,57,61,47,-4
2009/2010,Scotland Premier League,St. Mirren,7,13,18,36,49,34,-13
2009/2010,Spain LIGA BBVA,Athletic Club de Bilbao,15,9,14,50,53,54,-3
2009/2010,Spain LIGA BBVA,Atlético Madrid,13,8,17,57,61,47,-4
2009/2010,Spain LIGA BBVA,CA Osasuna,11,10,17,37,46,43,-9
2009/2010,Spain LIGA BBVA,CD Tenerife,9,9,20,40,74,36,-34
2009/2010,Spain LIGA BBVA,FC Barcelona,31,6,1,98,24,99,74
2009/2010,Spain LIGA BBVA,Getafe CF,17,7,14,58,48,58,10
2009/2010,Spain LIGA BBVA,Málaga CF,7,16,15,42,48,37,-6
2009/2010,Spain LIGA BBVA,RC Deportivo de La Coruña,13,8,17,35,49,47,-14
2009/2010,Spain LIGA BBVA,RCD Espanyol,11,11,16,29,46,44,-17
2009/2010,Spain LIGA BBVA,RCD Mallorca,18,8,12,59,44,62,15
2009/2010,Spain LIGA BBVA,Racing Santander,9,12,17,42,59,39,-17
2009/2010,Spain LIGA BBVA,Real Madrid CF,31,3,4,102,35,96,67
2009/2010,Spain LIGA BBVA,Real Sporting de Gijón,9,13,16,36,51,40,-15
2009/2010,Spain LIGA BBVA,Real Valladolid,7,15,16,37,62,36,-25
2009/2010,Spain LIGA BBVA,Real Zaragoza,10,11,17,46,64,41,-18
2009/2010,Spain LIGA BBVA,Sevilla FC,19,6,13,65,49,63,16
2009/2010,Spain LIGA BBVA,UD Almería,10,12,16,43,55,42,-12
2009/2010,Spain LIGA BBVA,Valencia CF,21,8,9,59,40,71,19
2009/2010,Spain LIGA BBVA,Villarreal CF,16,8,14,58,57,56,1
2009/2010,Spain LIGA BBVA,Xerez Club Deportivo,8,10,20,38,66,34,-28
2009/2010,Switzerland Super League,AC Bellinzona,7,4,25,42,92,25,-50
2009/2010,Switzerland Super League,BSC Young Boys,25,2,9,78,47,77,31
2009/2010,Switzerland Super League,FC Aarau,6,5,25,32,88,23,-56
2009/2010,Switzerland Super League,FC Basel,25,5,6,90,46,80,44
2009/2010,Switzerland Super League,FC Luzern,17,7,12,66,55,58,11
2009/2010,Switzerland Super League,FC Sion,14,9,13,63,57,51,6
2009/2010,Switzerland Super League,FC St. Gallen,13,7,16,53,56,46,-3
2009/2010,Switzerland Super League,FC Zürich,12,9,15,55,58,45,-3
2009/2010,Switzerland Super League,Grasshopper Club Zürich,21,2,13,65,43,65,22
2009/2010,Switzerland Super League,Neuchâtel Xamax,11,8,17,55,57,41,-2
2010/2011,Belgium Jupiler League,Beerschot AC,5,11,14,24,40,26,-16
2010/2011,Belgium Jupiler League,Club Brugge KV,16,5,9,60,35,53,25
2010/2011,Belgium Jupiler League,KAA Gent,17,6,7,59,42,57,17
2010/2011,Belgium Jupiler League,KAS Eupen,5,8,17,28,50,23,-22
2010/2011,Belgium Jupiler League,KRC Genk,19,7,4,64,27,64,37
2010/2011,Belgium Jupiler League,KSV Cercle Brugge,11,6,13,33,34,39,-1
2010/2011,Belgium Jupiler League,KV Kortrijk,11,5,14,36,39,38,-3
2010/2011,Belgium Jupiler League,KV Mechelen,13,9,8,34,30,48,4
2010/2011,Belgium Jupiler League,KVC Westerlo,11,8,11,41,40,41,1
2010/2011,Belgium Jupiler League,Lierse SK,4,12,14,26,58,24,-32
2010/2011,Belgium Jupiler League,RSC Anderlecht,19,8,3,58,20,65,38
2010/2011,Belgium Jupiler League,SV Zulte-Waregem,7,12,11,39,41,33,-2
2010/2011,Belgium Jupiler League,Sint-Truidense VV,8,5,17,20,51,29,-31
2010/2011,Belgium Jupiler League,Sporting Charleroi,4,7,19,20,54,19,-34
2010/2011,Belgium Jupiler League,Sporting Lokeren,13,11,6,43,36,50,7
2010/2011,Belgium Jupiler League,Standard de Liège,15,4,11,50,38,49,12
2010/2011,England Premier League,Arsenal,19,11,8,72,43,68,29
2010/2011,England Premier League,Aston Villa,12,12,14,48,59,48,-11
2010/2011,England Premier League,Birmingham City,8,15,15,37,58,39,-21
2010/2011,England Premier League,Blackburn Rovers,11,10,17,46,59,43,-13
2010/2011,England Premier League,Blackpool,10,9,19,55,78,39,-23
2010/2011,England Premier League,Bolton Wanderers,12,10,16,52,56,46,-4
2010/2011,England Premier League,Chelsea,21,8,9,69,33,71,36
2010/2011,England Premier League,Everton,13,15,10,51,45,54,6
2010/2011,England Premier League,Fulham,11,16,11,49,43,49,6
2010/2011,England Premier League,Liverpool,17,7,14,59,44,58,15
2010/2011,England Premier League,Manchester City,21,8,9,60,33,71,27
2010/2011,England Premier League,Manchester United,23,11,4,78,37,80,41
2010/2011,England Premier League,Newcastle United,11,13,14,56,57,46,-1
2010/2011,England Premier League,Stoke City,13,7,18,46,48,46,-2
2010/2011,England Premier League,Sunderland,12,11,15,45,56,47,-11
2010/2011,England Premier League,Tottenham Hotspur,16,14,8,55,46,62,9
2010/2011,England Premier League,West Bromwich Albion,12,11,15,56,71,47,-15
2010/2011,England Premier League,West Ham United,7,12,19,43,70,33,-27
2010/2011,England Premier League,Wigan Athletic,9,15,14,40,61,42,-21
2010/2011,England Premier League,Wolverhampton Wanderers,11,7,20,46,66,40,-20
2010/2011,France Ligue 1,AC Arles-Avignon,3,11,24,21,70,20,-49
2010/2011,France Ligue 1,AJ Auxerre,10,19,9,45,41,49,4
2010/2011,France Ligue 1,AS Monaco,9,17,12,36,40,44,-4
2010/2011,France Ligue 1,AS Nancy-Lorraine,13,9,16,43,48,48,-5
2010/2011,France Ligue 1,AS Saint-Étienne,12,13,13,46,47,49,-1
2010/2011,France Ligue 1,FC Lorient,12,13,13,46,48,49,-2
2010/2011,France Ligue 1,FC Sochaux-Montbéliard,17,7,14,60,43,58,17
2010/2011,France Ligue 1,Girondins de Bordeaux,12,15,11,43,42,51,1
2010/2011,France Ligue 1,LOSC Lille,21,13,4,68,36,76,32
2010/2011,France Ligue 1,Montpellier Hérault SC,12,11,15,32,43,47,-11
2010/2011,France Ligue 1,OGC Nice,11,13,14,33,48,46,-15
2010/2011,France Ligue 1,Olympique Lyonnais,17,13,8,61,40,64,21
2010/2011,France Ligue 1,Olympique de Marseille,18,14,6,62,39,68,23
2010/2011,France Ligue 1,Paris Saint-Germain,15,15,8,56,41,60,15
2010/2011,France Ligue 1,RC Lens,7,14,17,35,58,35,-23
2010/2011,France Ligue 1,SM Caen,11,13,14,46,51,46,-5
2010/2011,France Ligue 1,Stade Brestois 29,11,13,14,36,43,46,-7
2010/2011,France Ligue 1,Stade Rennais FC,15,11,12,38,35,56,3
2010/2011,France Ligue 1,Toulouse FC,14,8,16,38,36,50,2
2010/2011,France Ligue 1,Valenciennes FC,10,18,10,45,41,48,4
2010/2011,Germany 1. Bundesliga,1. FC Kaiserslautern,13,7,14,48,51,46,-3
2010/2011,Germany 1. Bundesliga,1. FC Köln,13,5,16,47,62,44,-15
2010/2011,Germany 1. Bundesliga,1. FC Nürnberg,13,8,13,47,45,47,2
2010/2011,Germany 1. Bundesliga,1. FSV Mainz 05,18,4,12,52,39,58,13
2010/2011,Germany 1. Bundesliga,Bayer 04 Leverkusen,20,8,6,64,44,68,20
2010/2011,Germany 1. Bundesliga,Borussia Dortmund,23,6,5,67,22,75,45
2010/2011,Germany 1. Bundesliga,Borussia Mönchengladbach,10,6,18,48,65,36,-17
2010/2011,Germany 1. Bundesliga,Eintracht Frankfurt,9,7,18,31,49,34,-18
2010/2011,Germany 1. Bundesliga,FC Bayern Munich,19,8,7,81,40,65,41
2010/2011,Germany 1. Bundesliga,FC Schalke 04,11,7,16,38,44,40,-6
2010/2011,Germany 1. Bundesliga,FC St. Pauli,8,5,21,35,68,29,-33
2010/2011,Germany 1. Bundesliga,Hamburger SV,12,9,13,46,52,45,-6
2010/2011,Germany 1. Bundesliga,Hannover 96,19,3,12,49,45,60,4
2010/2011,Germany 1. Bundesliga,SC Freiburg,13,5,16,41,50,44,-9
2010/2011,Germany 1. Bundesliga,SV Werder Bremen,10,11,13,47,61,41,-14
2010/2011,Germany 1. Bundesliga,TSG 1899 Hoffenheim,11,10,13,50,50,43,0
2010/2011,Germany 1. Bundesliga,VfB Stuttgart,12,6,16,60,59,42,1
2010/2011,Germany 1. Bundesliga,VfL Wolfsburg,9,11,14,43,48,38,-5
2010/2011,Italy Serie A,Bari,5,9,24,27,56,24,-29
2010/2011,Italy Serie A,Bologna,11,12,15,35,52,45,-17
2010/2011,Italy Serie A,Brescia,7,11,20,34,52,32,-18
2010/2011,Italy Serie A,Cagliari,12,9,17,44,51,45,-7
2010/2011,Italy Serie A,Catania,12,10,16,40,52,46,-12
2010/2011,Italy Serie A,Cesena,11,10,17,38,50,43,-12
2010/2011,Italy Serie A,Chievo Verona,11,13,14,38,40,46,-2
2010/2011,Italy Serie A,Fiorentina,12,15,11,49,44,51,5
2010/2011,Italy Serie A,Genoa,14,9,15,45,47,51,-2
2010/2011,Italy Serie A,Inter,23,7,8,69,42,76,27
2010/2011,Italy Serie A,Juventus,15,13,10,57,47,58,10
2010/2011,Italy Serie A,Lazio,20,6,12,55,39,66,16
2010/2011,Italy Serie A,Lecce,11,8,19,46,66,41,-20
2010/2011,Italy Serie A,Milan,24,10,4,65,24,82,41
2010/2011,Italy Serie A,Napoli,21,7,10,59,39,70,20
2010/2011,Italy Serie A,Palermo,17,5,16,58,63,56,-5
2010/2011,Italy Serie A,Parma,11,13,14,39,47,46,-8
2010/2011,Italy Serie A,Roma,18,9,11,59,52,63,7
2010/2011,Italy Serie A,Sampdoria,8,12,18,33,49,36,-16
2010/2011,Italy Serie A,Udinese,20,6,12,65,43,66,22
2010/2011,Netherlands Eredivisie,ADO Den Haag,16,6,12,63,55,54,8
2010/2011,Netherlands Eredivisie,AZ,17,8,9,55,44,59,11
2010/2011,Netherlands Eredivisie,Ajax,22,7,5,72,30,73,42
2010/2011,Netherlands Eredivisie,De Graafschap,9,11,14,31,56,38,-25
2010/2011,Netherlands Eredivisie,Excelsior,10,5,19,45,66,35,-21
2010/2011,Netherlands Eredivisie,FC Groningen,17,6,11,65,52,57,13
2010/2011,Netherlands Eredivisie,FC Twente,21,8,5,65,34,71,31
2010/2011,Netherlands Eredivisie,FC Utrecht,13,8,13,55,51,47,4
2010/2011,Netherlands Eredivisie,Feyenoord,12,8,14,53,54,44,-1
2010/2011,Netherlands Eredivisie,Heracles Almelo,14,7,13,65,56,49,9
2010/2011,Netherlands Eredivisie,N.E.C.,10,13,11,57,56,43,1
2010/2011,Netherlands Eredivisie,NAC Breda,12,5,17,44,60,41,-16
2010/2011,Netherlands Eredivisie,PSV,20,9,5,79,34,69,45
2010/2011,Netherlands Eredivisie,Roda JC Kerkrade,14,13,7,65,50,55,15
2010/2011,Netherlands Eredivisie,SC Heerenveen,10,11,13,60,54,41,6
2010/2011,Netherlands Eredivisie,VVV-Venlo,6,3,25,34,76,21,-42
2010/2011,Netherlands Eredivisie,Vitesse,9,8,17,42,61,35,-19
2010/2011,Netherlands Eredivisie,Willem II,3,6,25,37,98,15,-61
2010/2011,Poland Ekstraklasa,Arka Gdynia,6,10,14,22,43,28,-21
2010/2011,Poland Ekstraklasa,Cracovia,8,5,17,37,47,29,-10
2010/2011,Poland Ekstraklasa,GKS Bełchatów,10,10,10,31,33,40,-2
2010/2011,Poland Ekstraklasa,Jagiellonia Białystok,14,6,10,38,32,48,6
2010/2011,Poland Ekstraklasa,Korona Kielce,10,7,13,34,48,37,-14
2010/2011,Poland Ekstraklasa,Lech Poznań,13,6,11,37,23,45,14
2010/2011,Poland Ekstraklasa,Lechia Gdańsk,12,7,11,37,36,43,1
2010/2011,Poland Ekstraklasa,Legia Warszawa,15,4,11,45,38,49,7
2010/2011,Poland Ekstraklasa,P. Warszawa,12,8,10,41,26,44,15
2010/2011,Poland Ekstraklasa,Polonia Bytom,19,15,26,65,85,72,-20
2010/2011,Poland Ekstraklasa,Ruch Chorzów,10,8,12,29,32,38,-3
2010/2011,Poland Ekstraklasa,Widzew Łódź,11,10,9,41,34,43,7
2010/2011,Poland Ekstraklasa,Wisła Kraków,17,5,8,44,29,56,15
2010/2011,Poland Ekstraklasa,Zagłębie Lubin,10,9,11,31,38,39,-7
2010/2011,Poland Ekstraklasa,Śląsk Wrocław,13,10,7,46,34,49,12
2010/2011,Portugal Liga ZON Sagres,Académica de Coimbra,7,9,14,32,48,30,-16
2010/2011,Portugal Liga ZON Sagres,CD Nacional,11,9,10,28,31,42,-3
2010/2011,Portugal Liga ZON Sagres,CS Marítimo,9,8,13,33,32,35,1
2010/2011,Portugal Liga ZON Sagres,FC Paços de Ferreira,10,11,9,35,42,41,-7
2010/2011,Portugal Liga ZON Sagres,FC Porto,27,3,0,73,16,84,57
2010/2011,Portugal Liga ZON Sagres,Naval 1° de Maio,5,8,17,26,51,23,-25
2010/2011,Portugal Liga ZON Sagres,Portimonense,6,7,17,29,49,25,-20
2010/2011,Portugal Liga ZON Sagres,Rio Ave FC,10,8,12,35,33,38,2
2010/2011,Portugal Liga ZON Sagres,S.C. Olhanense,7,13,10,24,34,34,-10
2010/2011,Portugal Liga ZON Sagres,SC Beira Mar,7,12,11,32,36,33,-4
2010/2011,Portugal Liga ZON Sagres,SC Braga,13,7,10,45,33,46,12
2010/2011,Portugal Liga ZON Sagres,SL Benfica,20,3,7,61,31,63,30
2010/2011,Portugal Liga ZON Sagres,Sporting CP,13,9,8,41,31,48,10
2010/2011,Portugal Liga ZON Sagres,"União de Leiria, SAD",9,8,13,25,38,35,-13
2010/2011,Portugal Liga ZON Sagres,Vitória Guimarães,12,7,11,36,37,43,-1
2010/2011,Portugal Liga ZON Sagres,Vitória Setúbal,8,10,12,29,42,34,-13
2010/2011,Scotland Premier League,Aberdeen,11,5,22,39,59,38,-20
2010/2011,Scotland Premier League,Celtic,29,5,4,85,22,92,63
2010/2011,Scotland Premier League,Dundee United,17,10,11,55,50,61,5
2010/2011,Scotland Premier League,Hamilton Academical FC,5,11,22,24,59,26,-35
2010/2011,Scotland Premier League,Heart of Midlothian,18,9,11,53,45,63,8
2010/2011,Scotland Premier League,Hibernian,10,7,21,39,61,37,-22
2010/2011,Scotland Premier League,Inverness Caledonian Thistle,14,11,13,52,44,53,8
2010/2011,Scotland Premier League,Kilmarnock,13,10,15,53,55,49,-2
2010/2011,Scotland Premier League,Motherwell,13,7,18,40,60,46,-20
2010/2011,Scotland Premier League,Rangers,30,3,5,88,29,93,59
2010/2011,Scotland Premier League,St. Johnstone FC,11,11,16,23,43,44,-20
2010/2011,Scotland Premier League,St. Mirren,8,9,21,33,57,33,-24
2010/2011,Spain LIGA BBVA,Athletic Club de Bilbao,18,4,16,59,55,58,4
2010/2011,Spain LIGA BBVA,Atlético Madrid,17,7,14,62,53,58,9
2010/2011,Spain LIGA BBVA,CA Osasuna,13,8,17,45,46,47,-1
2010/2011,Spain LIGA BBVA,FC Barcelona,30,6,2,95,21,96,74
2010/2011,Spain LIGA BBVA,Getafe CF,12,8,18,49,60,44,-11
2010/2011,Spain LIGA BBVA,Hércules Club de Fútbol,9,8,21,36,60,35,-24
2010/2011,Spain LIGA BBVA,Levante UD,12,9,17,41,52,45,-11
2010/2011,Spain LIGA BBVA,Málaga CF,13,7,18,54,68,46,-14
2010/2011,Spain LIGA BBVA,RC Deportivo de La Coruña,10,13,15,31,47,43,-16
2010/2011,Spain LIGA BBVA,RCD Espanyol,15,4,19,46,55,49,-9
2010/2011,Spain LIGA BBVA,RCD Mallorca,12,8,18,41,56,44,-15
2010/2011,Spain LIGA BBVA,Racing Santander,12,10,16,41,56,46,-15
2010/2011,Spain LIGA BBVA,Real Madrid CF,29,5,4,102,33,92,69
2010/2011,Spain LIGA BBVA,Real Sociedad,14,3,21,49,66,45,-17
2010/2011,Spain LIGA BBVA,Real Sporting de Gijón,11,14,13,35,42,47,-7
2010/2011,Spain LIGA BBVA,Real Zaragoza,12,9,17,40,53,45,-13
2010/2011,Spain LIGA BBVA,Sevilla FC,17,7,14,62,61,58,1
2010/2011,Spain LIGA BBVA,UD Almería,6,12,20,36,70,30,-34
2010/2011,Spain LIGA BBVA,Valencia CF,21,8,9,64,44,71,20
2010/2011,Spain LIGA BBVA,Villarreal CF,18,8,12,54,44,62,10
2010/2011,Switzerland Super League,AC Bellinzona,7,11,18,42,75,32,-33
2010/2011,Switzerland Super League,BSC Young Boys,15,12,9,65,50,57,15
2010/2011,Switzerland Super League,FC Basel,21,10,5,76,44,73,32
2010/2011,Switzerland Super League,FC Luzern,13,9,14,62,57,48,5
2010/2011,Switzerland Super League,FC Sion,15,9,12,47,36,54,11
2010/2011,Switzerland Super League,FC St. Gallen,8,7,21,34,67,31,-33
2010/2011,Switzerland Super League,FC Thun,11,16,9,48,43,49,5
2010/2011,Switzerland Super League,FC Zürich,21,9,6,74,44,72,30
2010/2011,Switzerland Super League,Grasshopper Club Zürich,10,11,15,45,54,41,-9
2010/2011,Switzerland Super League,Neuchâtel Xamax,8,8,20,44,67,32,-23
2011/2012,Belgium Jupiler League,Beerschot AC,9,9,12,45,51,36,-6
2011/2012,Belgium Jupiler League,Club Brugge KV,19,4,7,51,32,61,19
2011/2012,Belgium Jupiler League,KAA Gent,17,5,8,63,35,56,28
2011/2012,Belgium Jupiler League,KRC Genk,13,7,10,60,44,46,16
2011/2012,Belgium Jupiler League,KSV Cercle Brugge,13,7,10,36,37,46,-1
2011/2012,Belgium Jupiler League,KV Kortrijk,13,7,10,39,36,46,3
2011/2012,Belgium Jupiler League,KV Mechelen,10,7,13,40,50,37,-10
2011/2012,Belgium Jupiler League,KVC Westerlo,5,5,20,29,59,20,-30
2011/2012,Belgium Jupiler League,Lierse SK,6,13,11,24,36,31,-12
2011/2012,Belgium Jupiler League,Oud-Heverlee Leuven,7,8,15,38,58,29,-20
2011/2012,Belgium Jupiler League,RAEC Mons,9,9,12,50,55,36,-5
2011/2012,Belgium Jupiler League,RSC Anderlecht,20,7,3,61,26,67,35
2011/2012,Belgium Jupiler League,SV Zulte-Waregem,6,12,12,32,38,30,-6
2011/2012,Belgium Jupiler League,Sint-Truidense VV,3,10,17,32,61,19,-29
2011/2012,Belgium Jupiler League,Sporting Lokeren,11,11,8,48,40,44,8
2011/2012,Belgium Jupiler League,Standard de Liège,14,9,7,43,33,51,10
2011/2012,England Premier League,Arsenal,21,7,10,74,49,70,25
2011/2012,England Premier League,Aston Villa,7,17,14,37,53,38,-16
2011/2012,England Premier League,Blackburn Rovers,8,7,23,48,78,31,-30
2011/2012,England Premier League,Bolton Wanderers,10,6,22,46,77,36,-31
2011/2012,England Premier League,Chelsea,18,10,10,65,46,64,19
2011/2012,England Premier League,Everton,15,11,12,50,40,56,10
2011/2012,England Premier League,Fulham,14,10,14,48,51,52,-3
2011/2012,England Premier League,Liverpool,14,10,14,47,40,52,7
2011/2012,England Premier League,Manchester City,28,5,5,93,29,89,64
2011/2012,England Premier League,Manchester United,28,5,5,89,33,89,56
2011/2012,England Premier League,Newcastle United,19,8,11,56,51,65,5
2011/2012,England Premier League,Norwich City,12,11,15,52,66,47,-14
2011/2012,England Premier League,Queens Park Rangers,10,7,21,43,66,37,-23
2011/2012,England Premier League,Stoke City,11,12,15,36,53,45,-17
2011/2012,England Premier League,Sunderland,11,12,15,45,46,45,-1
2011/2012,England Premier League,Swansea City,12,11,15,44,51,47,-7
2011/2012,England Premier League,Tottenham Hotspur,20,9,9,66,41,69,25
2011/2012,England Premier League,West Bromwich Albion,13,8,17,45,52,47,-7
2011/2012,England Premier League,Wigan Athletic,11,10,17,42,62,43,-20
2011/2012,England Premier League,Wolverhampton Wanderers,5,10,23,40,82,25,-42
2011/2012,France Ligue 1,AC Ajaccio,9,14,15,40,61,41,-21
2011/2012,France Ligue 1,AJ Auxerre,7,13,18,46,57,34,-11
2011/2012,France Ligue 1,AS Nancy-Lorraine,11,12,15,38,48,45,-10
2011/2012,France Ligue 1,AS Saint-Étienne,16,9,13,49,45,57,4
2011/2012,France Ligue 1,Dijon FCO,9,9,20,38,63,36,-25
2011/2012,France Ligue 1,FC Lorient,9,12,17,35,49,39,-14
2011/2012,France Ligue 1,FC Sochaux-Montbéliard,11,9,18,40,60,42,-20
2011/2012,France Ligue 1,Girondins de Bordeaux,16,13,9,53,41,61,12
2011/2012,France Ligue 1,LOSC Lille,21,11,6,72,39,74,33
2011/2012,France Ligue 1,Montpellier Hérault SC,25,7,6,68,34,82,34
2011/2012,France Ligue 1,OGC Nice,10,12,16,39,46,42,-7
2011/2012,France Ligue 1,Olympique Lyonnais,19,7,12,64,51,64,13
2011/2012,France Ligue 1,Olympique de Marseille,12,12,14,45,41,48,4
2011/2012,France Ligue 1,Paris Saint-Germain,23,10,5,75,41,79,34
2011/2012,France Ligue 1,SM Caen,9,11,18,39,59,38,-20
2011/2012,France Ligue 1,Stade Brestois 29,8,17,13,31,38,41,-7
2011/2012,France Ligue 1,Stade Rennais FC,17,9,12,53,44,60,9
2011/2012,France Ligue 1,Toulouse FC,15,11,12,37,34,56,3
2011/2012,France Ligue 1,Valenciennes FC,12,7,19,40,50,43,-10
2011/2012,France Ligue 1,Évian Thonon Gaillard FC,13,11,14,54,55,50,-1
2011/2012,Germany 1. Bundesliga,1. FC Kaiserslautern,4,11,19,24,54,23,-30
2011/2012,Germany 1. Bundesliga,1. FC Köln,8,6,20,39,75,30,-36
2011/2012,Germany 1. Bundesliga,1. FC Nürnberg,12,6,16,38,49,42,-11
2011/2012,Germany 1. Bundesliga,1. FSV Mainz 05,9,12,13,47,51,39,-4
2011/2012,Germany 1. Bundesliga,Bayer 04 Leverkusen,15,9,10,52,44,54,8
2011/2012,Germany 1. Bundesliga,Borussia Dortmund,25,6,3,80,25,81,55
2011/2012,Germany 1. Bundesliga,Borussia Mönchengladbach,17,9,8,49,24,60,25
2011/2012,Germany 1. Bundesliga,FC Augsburg,8,14,12,36,49,38,-13
2011/2012,Germany 1. Bundesliga,FC Bayern Munich,23,4,7,77,22,73,55
2011/2012,Germany 1. Bundesliga,FC Schalke 04,20,4,10,74,44,64,30
2011/2012,Germany 1. Bundesliga,Hamburger SV,8,12,14,35,57,36,-22
2011/2012,Germany 1. Bundesliga,Hannover 96,12,12,10,41,45,48,-4
2011/2012,Germany 1. Bundesliga,Hertha BSC Berlin,7,10,17,38,64,31,-26
2011/2012,Germany 1. Bundesliga,SC Freiburg,10,10,14,45,61,40,-16
2011/2012,Germany 1. Bundesliga,SV Werder Bremen,11,9,14,49,58,42,-9
2011/2012,Germany 1. Bundesliga,TSG 1899 Hoffenheim,10,11,13,41,47,41,-6
2011/2012,Germany 1. Bundesliga,VfB Stuttgart,15,8,11,63,46,53,17
2011/2012,Germany 1. Bundesliga,VfL Wolfsburg,13,5,16,47,60,44,-13
2011/2012,Italy Serie A,Atalanta,13,11,11,40,40,50,0
2011/2012,Italy Serie A,Bologna,11,11,13,36,41,44,-5
2011/2012,Italy Serie A,Cagliari,9,13,14,35,43,40,-8
2011/2012,Italy Serie A,Catania,10,12,12,42,48,42,-6
2011/2012,Italy Serie A,Cesena,4,8,22,24,56,20,-32
2011/2012,Italy Serie A,Chievo Verona,11,13,13,33,44,46,-11
2011/2012,Italy Serie A,Fiorentina,10,12,12,32,38,42,-6
2011/2012,Italy Serie A,Genoa,11,7,18,48,67,40,-19
2011/2012,Italy Serie A,Inter,17,6,14,56,53,57,3
2011/2012,Italy Serie A,Juventus,22,13,0,64,19,79,45
2011/2012,Italy Serie A,Lazio,17,8,11,53,43,59,10
2011/2012,Italy Serie A,Lecce,8,10,17,38,52,34,-14
2011/2012,Italy Serie A,Milan,23,8,6,72,33,77,39
2011/2012,Italy Serie A,Napoli,16,12,8,64,41,60,23
2011/2012,Italy Serie A,Novara,6,11,19,34,64,29,-30
2011/2012,Italy Serie A,Palermo,11,10,17,52,62,43,-10
2011/2012,Italy Serie A,Parma,15,9,12,51,50,54,1
2011/2012,Italy Serie A,Roma,16,8,13,59,52,56,7
2011/2012,Italy Serie A,Siena,9,11,16,40,45,38,-5
2011/2012,Italy Serie A,Udinese,18,9,9,52,34,63,18
2011/2012,Netherlands Eredivisie,ADO Den Haag,8,8,18,38,67,32,-29
2011/2012,Netherlands Eredivisie,AZ,19,8,7,64,35,65,29
2011/2012,Netherlands Eredivisie,Ajax,23,7,4,93,36,76,57
2011/2012,Netherlands Eredivisie,De Graafschap,6,6,22,36,74,24,-38
2011/2012,Netherlands Eredivisie,Excelsior,4,7,23,28,76,19,-48
2011/2012,Netherlands Eredivisie,FC Groningen,10,7,17,41,61,37,-20
2011/2012,Netherlands Eredivisie,FC Twente,17,9,8,82,46,60,36
2011/2012,Netherlands Eredivisie,FC Utrecht,11,10,13,55,58,43,-3
2011/2012,Netherlands Eredivisie,Feyenoord,21,7,6,70,37,70,33
2011/2012,Netherlands Eredivisie,Heracles Almelo,11,7,16,52,62,40,-10
2011/2012,Netherlands Eredivisie,N.E.C.,13,6,15,42,45,45,-3
2011/2012,Netherlands Eredivisie,NAC Breda,10,8,16,45,54,38,-9
2011/2012,Netherlands Eredivisie,PSV,21,6,7,87,47,69,40
2011/2012,Netherlands Eredivisie,RKC Waalwijk,13,6,15,40,49,45,-9
2011/2012,Netherlands Eredivisie,Roda JC Kerkrade,14,2,18,55,70,44,-15
2011/2012,Netherlands Eredivisie,SC Heerenveen,18,10,6,79,59,64,20
2011/2012,Netherlands Eredivisie,VVV-Venlo,9,4,21,42,78,31,-36
2011/2012,Netherlands Eredivisie,Vitesse,15,8,11,48,43,53,5
2011/2012,Poland Ekstraklasa,Cracovia,4,10,16,20,41,22,-21
2011/2012,Poland Ekstraklasa,GKS Bełchatów,7,10,13,34,36,31,-2
2011/2012,Poland Ekstraklasa,Jagiellonia Białystok,11,6,13,35,45,39,-10
2011/2012,Poland Ekstraklasa,Korona Kielce,13,9,8,34,29,48,5
2011/2012,Poland Ekstraklasa,Lech Poznań,15,7,8,42,22,52,20
2011/2012,Poland Ekstraklasa,Lechia Gdańsk,7,10,13,21,30,31,-9
2011/2012,Poland Ekstraklasa,Legia Warszawa,15,8,7,42,17,53,25
2011/2012,Poland Ekstraklasa,P. Warszawa,13,6,11,33,32,45,1
2011/2012,Poland Ekstraklasa,Podbeskidzie Bielsko-Biała,9,8,13,26,39,35,-13
2011/2012,Poland Ekstraklasa,Polonia Bytom,11,9,10,36,30,42,6
2011/2012,Poland Ekstraklasa,Ruch Chorzów,16,7,7,44,28,55,16
2011/2012,Poland Ekstraklasa,Widzew Łódź,14,21,25,48,79,63,-31
2011/2012,Poland Ekstraklasa,Wisła Kraków,12,7,11,29,26,43,3
2011/2012,Poland Ekstraklasa,Zagłębie Lubin,11,7,12,36,42,40,-6
2011/2012,Poland Ekstraklasa,Śląsk Wrocław,17,5,8,47,31,56,16
2011/2012,Portugal Liga ZON Sagres,Académica de Coimbra,7,8,15,27,38,29,-11
2011/2012,Portugal Liga ZON Sagres,CD Nacional,13,5,12,48,50,44,-2
2011/2012,Portugal Liga ZON Sagres,CS Marítimo,14,8,8,41,38,50,3
2011/2012,Portugal Liga ZON Sagres,FC Paços de Ferreira,8,7,15,35,53,31,-18
2011/2012,Portugal Liga ZON Sagres,FC Porto,23,6,1,69,19,75,50
2011/2012,Portugal Liga ZON Sagres,Feirense,5,9,16,27,49,24,-22
2011/2012,Portugal Liga ZON Sagres,Gil Vicente FC,8,10,12,31,42,34,-11
2011/2012,Portugal Liga ZON Sagres,Rio Ave FC,7,7,16,33,42,28,-9
2011/2012,Portugal Liga ZON Sagres,S.C. Olhanense,9,12,9,36,38,39,-2
2011/2012,Portugal Liga ZON Sagres,SC Beira Mar,8,5,17,26,38,29,-12
2011/2012,Portugal Liga ZON Sagres,SC Braga,19,5,6,59,29,62,30
2011/2012,Portugal Liga ZON Sagres,SL Benfica,21,6,3,66,27,69,39
2011/2012,Portugal Liga ZON Sagres,Sporting CP,18,5,7,47,26,59,21
2011/2012,Portugal Liga ZON Sagres,"União de Leiria, SAD",5,4,21,25,56,19,-31
2011/2012,Portugal Liga ZON Sagres,Vitória Guimarães,14,3,13,40,40,45,0
2011/2012,Portugal Liga ZON Sagres,Vitória Setúbal,8,6,16,24,49,30,-25
2011/2012,Scotland Premier League,Aberdeen,9,14,15,36,44,41,-8
2011/2012,Scotland Premier League,Celtic,30,3,5,84,21,93,63
2011/2012,Scotland Premier League,Dundee United,16,11,11,62,50,59,12
2011/2012,Scotland Premier League,Dunfermline Athletic,5,10,23,40,82,25,-42
2011/2012,Scotland Premier League,Heart of Midlothian,15,7,16,45,43,52,2
2011/2012,Scotland Premier League,Hibernian,8,9,21,40,67,33,-27
2011/2012,Scotland Premier League,Inverness Caledonian Thistle,10,9,19,42,60,39,-18
2011/2012,Scotland Premier League,Kilmarnock,11,14,13,44,61,47,-17
2011/2012,Scotland Premier League,Motherwell,18,8,12,49,44,62,5
2011/2012,Scotland Premier League,Rangers,26,5,7,77,28,83,49
2011/2012,Scotland Premier League,St. Johnstone FC,14,8,16,43,50,50,-7
2011/2012,Scotland Premier League,St. Mirren,9,16,13,39,51,43,-12
2011/2012,Spain LIGA BBVA,Athletic Club de Bilbao,12,13,13,49,52,49,-3
2011/2012,Spain LIGA BBVA,Atlético Madrid,15,11,12,53,46,56,7
2011/2012,Spain LIGA BBVA,CA Osasuna,13,15,10,44,61,54,-17
2011/2012,Spain LIGA BBVA,FC Barcelona,28,7,3,114,29,91,85
2011/2012,Spain LIGA BBVA,Getafe CF,12,11,15,40,51,47,-11
2011/2012,Spain LIGA BBVA,Granada CF,12,6,20,35,56,42,-21
2011/2012,Spain LIGA BBVA,Levante UD,16,7,15,54,50,55,4
2011/2012,Spain LIGA BBVA,Málaga CF,17,7,14,54,53,58,1
2011/2012,Spain LIGA BBVA,RCD Espanyol,12,10,16,46,56,46,-10
2011/2012,Spain LIGA BBVA,RCD Mallorca,14,10,14,42,46,52,-4
2011/2012,Spain LIGA BBVA,Racing Santander,4,15,19,28,63,27,-35
2011/2012,Spain LIGA BBVA,Rayo Vallecano,13,4,21,53,73,43,-20
2011/2012,Spain LIGA BBVA,Real Betis Balompié,13,8,17,47,56,47,-9
2011/2012,Spain LIGA BBVA,Real Madrid CF,32,4,2,121,32,100,89
2011/2012,Spain LIGA BBVA,Real Sociedad,12,11,15,46,52,47,-6
2011/2012,Spain LIGA BBVA,Real Sporting de Gijón,10,7,21,42,69,37,-27
2011/2012,Spain LIGA BBVA,Real Zaragoza,12,7,19,36,61,43,-25
2011/2012,Spain LIGA BBVA,Sevilla FC,13,11,14,48,47,50,1
2011/2012,Spain LIGA BBVA,Valencia CF,17,10,11,59,44,61,15
2011/2012,Spain LIGA BBVA,Villarreal CF,9,14,15,39,53,41,-14
2011/2012,Switzerland Super League,BSC Young Boys,13,12,9,52,38,51,14
2011/2012,Switzerland Super League,FC Basel,22,8,4,78,33,74,45
2011/2012,Switzerland Super League,FC Lausanne-Sports,8,6,20,29,61,30,-32
2011/2012,Switzerland Super League,FC Luzern,14,12,8,46,32,54,14
2011/2012,Switzerland Super League,FC Sion,15,8,11,40,35,53,5
2011/2012,Switzerland Super League,FC Thun,11,10,13,38,41,43,-3
2011/2012,Switzerland Super League,FC Zürich,11,8,15,43,44,41,-1
2011/2012,Switzerland Super League,Grasshopper Club Zürich,7,5,22,32,66,26,-34
2011/2012,Switzerland Super League,Neuchâtel Xamax,7,5,6,22,22,26,0
2011/2012,Switzerland Super League,Servette FC,14,6,14,45,53,48,-8
2012/2013,Belgium Jupiler League,Beerschot AC,6,5,19,31,61,23,-30
2012/2013,Belgium Jupiler League,Club Brugge KV,15,9,6,66,43,54,23
2012/2013,Belgium Jupiler League,KAA Gent,8,10,12,33,40,34,-7
2012/2013,Belgium Jupiler League,KRC Genk,15,10,5,63,40,55,23
2012/2013,Belgium Jupiler League,KSV Cercle Brugge,3,5,22,30,65,14,-35
2012/2013,Belgium Jupiler League,KV Kortrijk,11,6,13,31,30,39,1
2012/2013,Belgium Jupiler League,KV Mechelen,12,5,13,44,42,41,2
2012/2013,Belgium Jupiler League,Lierse SK,5,11,14,28,53,26,-25
2012/2013,Belgium Jupiler League,Oud-Heverlee Leuven,8,12,10,46,51,36,-5
2012/2013,Belgium Jupiler League,RAEC Mons,13,5,12,48,53,44,-5
2012/2013,Belgium Jupiler League,RSC Anderlecht,20,7,3,69,27,67,42
2012/2013,Belgium Jupiler League,SV Zulte-Waregem,19,6,5,49,29,63,20
2012/2013,Belgium Jupiler League,Sporting Charleroi,10,4,16,30,49,34,-19
2012/2013,Belgium Jupiler League,Sporting Lokeren,14,9,7,53,38,51,15
2012/2013,Belgium Jupiler League,Standard de Liège,15,5,10,54,33,50,21
2012/2013,Belgium Jupiler League,Waasland-Beveren,7,9,14,28,49,30,-21
2012/2013,England Premier League,Arsenal,21,10,7,72,37,73,35
2012/2013,England Premier League,Aston Villa,10,11,17,47,69,41,-22
2012/2013,England Premier League,Chelsea,22,9,7,75,39,75,36
2012/2013,England Premier League,Everton,16,15,7,55,40,63,15
2012/2013,England Premier League,Fulham,11,10,17,50,60,43,-10
2012/2013,England Premier League,Liverpool,16,13,9,71,43,61,28
2012/2013,England Premier League,Manchester City,23,9,6,66,34,78,32
2012/2013,England Premier League,Manchester United,28,5,5,86,43,89,43
2012/2013,England Premier League,Newcastle United,11,8,19,45,68,41,-23
2012/2013,England Premier League,Norwich City,10,14,14,41,58,44,-17
2012/2013,England Premier League,Queens Park Rangers,4,13,21,30,60,25,-30
2012/2013,England Premier League,Reading,6,10,22,43,73,28,-30
2012/2013,England Premier League,Southampton,9,14,15,49,60,41,-11
2012/2013,England Premier League,Stoke City,9,15,14,34,45,42,-11
2012/2013,England Premier League,Sunderland,9,12,17,41,54,39,-13
2012/2013,England Premier League,Swansea City,11,13,14,47,51,46,-4
2012/2013,England Premier League,Tottenham Hotspur,21,9,8,66,46,72,20
2012/2013,England Premier League,West Bromwich Albion,14,7,17,53,57,49,-4
2012/2013,England Premier League,West Ham United,12,10,16,45,53,46,-8
2012/2013,England Premier League,Wigan Athletic,9,9,20,47,73,36,-26
2012/2013,France Ligue 1,AC Ajaccio,9,15,14,39,51,42,-12
2012/2013,France Ligue 1,AS Nancy-Lorraine,9,11,18,38,58,38,-20
2012/2013,France Ligue 1,AS Saint-Étienne,16,15,7,60,32,63,28
2012/2013,France Ligue 1,ES Troyes AC,8,13,17,43,61,37,-18
2012/2013,France Ligue 1,FC Lorient,14,11,13,57,58,53,-1
2012/2013,France Ligue 1,FC Sochaux-Montbéliard,10,11,17,41,57,41,-16
2012/2013,France Ligue 1,Girondins de Bordeaux,13,16,9,40,34,55,6
2012/2013,France Ligue 1,LOSC Lille,16,14,8,59,40,62,19
2012/2013,France Ligue 1,Montpellier Hérault SC,15,7,16,54,51,52,3
2012/2013,France Ligue 1,OGC Nice,18,10,10,57,46,64,11
2012/2013,France Ligue 1,Olympique Lyonnais,19,10,9,61,38,67,23
2012/2013,France Ligue 1,Olympique de Marseille,21,8,9,42,36,71,6
2012/2013,France Ligue 1,Paris Saint-Germain,25,8,5,69,23,83,46
2012/2013,France Ligue 1,SC Bastia,13,8,17,50,66,47,-16
2012/2013,France Ligue 1,Stade Brestois 29,8,5,25,32,62,29,-30
2012/2013,France Ligue 1,Stade Rennais FC,13,7,18,48,59,46,-11
2012/2013,France Ligue 1,Stade de Reims,10,13,15,33,42,43,-9
2012/2013,France Ligue 1,Toulouse FC,13,12,13,49,47,51,2
2012/2013,France Ligue 1,Valenciennes FC,12,12,14,49,53,48,-4
2012/2013,France Ligue 1,Évian Thonon Gaillard FC,10,10,18,46,53,40,-7
2012/2013,Germany 1. Bundesliga,1. FC Nürnberg,11,11,12,39,47,44,-8
2012/2013,Germany 1. Bundesliga,1. FSV Mainz 05,10,12,12,42,44,42,-2
2012/2013,Germany 1. Bundesliga,Bayer 04 Leverkusen,19,8,7,65,39,65,26
2012/2013,Germany 1. Bundesliga,Borussia Dortmund,19,9,6,81,42,66,39
2012/2013,Germany 1. Bundesliga,Borussia Mönchengladbach,12,11,11,45,49,47,-4
2012/2013,Germany 1. Bundesliga,Eintracht Frankfurt,14,9,11,49,46,51,3
2012/2013,Germany 1. Bundesliga,FC Augsburg,8,9,17,33,51,33,-18
2012/2013,Germany 1. Bundesliga,FC Bayern Munich,29,4,1,98,18,91,80
2012/2013,Germany 1. Bundesliga,FC Schalke 04,16,7,11,58,50,55,8
2012/2013,Germany 1. Bundesliga,Fortuna Düsseldorf,7,9,18,39,57,30,-18
2012/2013,Germany 1. Bundesliga,Hamburger SV,14,6,14,42,53,48,-11
2012/2013,Germany 1. Bundesliga,Hannover 96,13,6,15,60,62,45,-2
2012/2013,Germany 1. Bundesliga,SC Freiburg,14,9,11,45,40,51,5
2012/2013,Germany 1. Bundesliga,SV Werder Bremen,8,10,16,50,66,34,-16
2012/2013,Germany 1. Bundesliga,SpVgg Greuther Fürth,4,9,21,26,60,21,-34
2012/2013,Germany 1. Bundesliga,TSG 1899 Hoffenheim,8,7,19,42,67,31,-25
2012/2013,Germany 1. Bundesliga,VfB Stuttgart,12,7,15,37,55,43,-18
2012/2013,Germany 1. Bundesliga,VfL Wolfsburg,10,13,11,47,52,43,-5
2012/2013,Italy Serie A,Atalanta,11,9,18,39,56,42,-17
2012/2013,Italy Serie A,Bologna,11,11,16,46,52,44,-6
2012/2013,Italy Serie A,Cagliari,12,11,15,43,55,47,-12
2012/2013,Italy Serie A,Catania,15,11,12,50,46,56,4
2012/2013,Italy Serie A,Chievo Verona,12,9,17,37,52,45,-15
2012/2013,Italy Serie A,Fiorentina,21,7,10,72,44,70,28
2012/2013,Italy Serie A,Genoa,8,14,16,38,52,38,-14
2012/2013,Italy Serie A,Inter,16,6,16,55,57,54,-2
2012/2013,Italy Serie A,Juventus,27,6,5,71,24,87,47
2012/2013,Italy Serie A,Lazio,18,7,13,51,42,61,9
2012/2013,Italy Serie A,Milan,21,9,8,67,39,72,28
2012/2013,Italy Serie A,Napoli,23,9,6,73,36,78,37
2012/2013,Italy Serie A,Palermo,6,14,18,34,54,32,-20
2012/2013,Italy Serie A,Parma,13,10,15,45,46,49,-1
2012/2013,Italy Serie A,Pescara,6,4,28,27,84,22,-57
2012/2013,Italy Serie A,Roma,18,8,12,71,56,62,15
2012/2013,Italy Serie A,Sampdoria,11,10,17,43,51,43,-8
2012/2013,Italy Serie A,Siena,9,9,20,36,57,36,-21
2012/2013,Italy Serie A,Torino,8,16,14,46,55,40,-9
2012/2013,Italy Serie A,Udinese,18,12,8,59,45,66,14
2012/2013,Netherlands Eredivisie,ADO Den Haag,9,13,12,49,63,40,-14
2012/2013,Netherlands Eredivisie,AZ,10,9,15,56,54,39,2
2012/2013,Netherlands Eredivisie,Ajax,22,10,2,83,31,76,52
2012/2013,Netherlands Eredivisie,FC Groningen,12,7,15,36,53,43,-17
2012/2013,Netherlands Eredivisie,FC Twente,17,11,6,60,33,62,27
2012/2013,Netherlands Eredivisie,FC Utrecht,19,6,9,55,41,63,14
2012/2013,Netherlands Eredivisie,Feyenoord,21,6,7,64,38,69,26
2012/2013,Netherlands Eredivisie,Heracles Almelo,9,11,14,58,71,38,-13
2012/2013,Netherlands Eredivisie,N.E.C.,10,7,17,44,66,37,-22
2012/2013,Netherlands Eredivisie,NAC Breda,10,8,16,40,56,38,-16
2012/2013,Netherlands Eredivisie,PEC Zwolle,10,9,15,42,55,39,-13
2012/2013,Netherlands Eredivisie,PSV,22,3,9,103,43,69,60
2012/2013,Netherlands Eredivisie,RKC Waalwijk,9,10,15,39,48,37,-9
2012/2013,Netherlands Eredivisie,Roda JC Kerkrade,7,12,15,51,69,33,-18
2012/2013,Netherlands Eredivisie,SC Heerenveen,11,9,14,50,63,42,-13
2012/2013,Netherlands Eredivisie,VVV-Venlo,6,10,18,33,62,28,-29
2012/2013,Netherlands Eredivisie,Vitesse,19,7,8,68,42,64,26
2012/2013,Netherlands Eredivisie,Willem II,5,8,21,33,76,23,-43
2012/2013,Poland Ekstraklasa,GKS Bełchatów,7,10,13,24,38,31,-14
2012/2013,Poland Ekstraklasa,Jagiellonia Białystok,8,13,9,31,45,37,-14
2012/2013,Poland Ekstraklasa,Korona Kielce,9,9,12,32,37,36,-5
2012/2013,Poland Ekstraklasa,Lech Poznań,19,4,7,46,22,61,24
2012/2013,Poland Ekstraklasa,Lechia Gdańsk,10,8,12,42,43,38,-1
2012/2013,Poland Ekstraklasa,Legia Warszawa,20,7,3,59,22,67,37
2012/2013,Poland Ekstraklasa,P. Warszawa,11,9,10,45,34,42,11
2012/2013,Poland Ekstraklasa,Piast Gliwice,13,7,10,41,41,46,0
2012/2013,Poland Ekstraklasa,Podbeskidzie Bielsko-Biała,8,8,14,39,43,32,-4
2012/2013,Poland Ekstraklasa,Pogoń Szczecin,10,5,15,29,39,35,-10
2012/2013,Poland Ekstraklasa,Polonia Bytom,12,7,11,35,31,43,4
2012/2013,Poland Ekstraklasa,Ruch Chorzów,8,7,15,35,48,31,-13
2012/2013,Poland Ekstraklasa,Widzew Łódź,8,9,13,30,41,33,-11
2012/2013,Poland Ekstraklasa,Wisła Kraków,10,8,12,28,35,38,-7
2012/2013,Poland Ekstraklasa,Zagłębie Lubin,11,7,12,38,37,40,1
2012/2013,Poland Ekstraklasa,Śląsk Wrocław,13,8,9,44,42,47,2
2012/2013,Portugal Liga ZON Sagres,Académica de Coimbra,6,10,14,33,45,28,-12
2012/2013,Portugal Liga ZON Sagres,CD Nacional,11,7,12,45,51,40,-6
2012/2013,Portugal Liga ZON Sagres,CS Marítimo,9,11,10,34,45,38,-11
2012/2013,Portugal Liga ZON Sagres,Estoril Praia,13,6,11,47,37,45,10
2012/2013,Portugal Liga ZON Sagres,FC Paços de Ferreira,14,12,4,42,29,54,13
2012/2013,Portugal Liga ZON Sagres,FC Porto,24,6,0,70,14,78,56
2012/2013,Portugal Liga ZON Sagres,Gil Vicente FC,6,7,17,31,54,25,-23
2012/2013,Portugal Liga ZON Sagres,Moreirense FC,5,9,16,30,51,24,-21
2012/2013,Portugal Liga ZON Sagres,Rio Ave FC,12,6,12,35,42,42,-7
2012/2013,Portugal Liga ZON Sagres,S.C. Olhanense,5,10,15,26,42,25,-16
2012/2013,Portugal Liga ZON Sagres,SC Beira Mar,5,8,17,35,55,23,-20
2012/2013,Portugal Liga ZON Sagres,SC Braga,16,4,10,60,44,52,16
2012/2013,Portugal Liga ZON Sagres,SL Benfica,24,5,1,77,20,77,57
2012/2013,Portugal Liga ZON Sagres,Sporting CP,11,9,10,36,36,42,0
2012/2013,Portugal Liga ZON Sagres,Vitória Guimarães,11,7,12,36,47,40,-11
2012/2013,Portugal Liga ZON Sagres,Vitória Setúbal,7,5,18,30,55,26,-25
2012/2013,Scotland Premier League,Aberdeen,11,15,12,41,43,48,-2
2012/2013,Scotland Premier League,Celtic,24,7,7,92,35,79,57
2012/2013,Scotland Premier League,Dundee FC,7,9,22,28,66,30,-38
2012/2013,Scotland Premier League,Dundee United,11,14,13,51,62,47,-11
2012/2013,Scotland Premier League,Heart of Midlothian,11,11,16,40,49,44,-9
2012/2013,Scotland Premier League,Hibernian,13,12,13,49,52,51,-3
2012/2013,Scotland Premier League,Inverness Caledonian Thistle,13,15,10,64,60,54,4
2012/2013,Scotland Premier League,Kilmarnock,11,12,15,52,53,45,-1
2012/2013,Scotland Premier League,Motherwell,18,9,11,67,51,63,16
2012/2013,Scotland Premier League,Ross County FC,13,14,11,47,48,53,-1
2012/2013,Scotland Premier League,St. Johnstone FC,14,14,10,45,44,56,1
2012/2013,Scotland Premier League,St. Mirren,9,14,15,47,60,41,-13
2012/2013,Spain LIGA BBVA,Athletic Club de Bilbao,12,9,17,44,65,45,-21
2012/2013,Spain LIGA BBVA,Atlético Madrid,23,7,8,65,31,76,34
2012/2013,Spain LIGA BBVA,CA Osasuna,10,9,19,33,50,39,-17
2012/2013,Spain LIGA BBVA,FC Barcelona,32,4,2,115,40,100,75
2012/2013,Spain LIGA BBVA,Getafe CF,13,8,17,43,57,47,-14
2012/2013,Spain LIGA BBVA,Granada CF,11,9,18,37,54,42,-17
2012/2013,Spain LIGA BBVA,Levante UD,12,10,16,40,57,46,-17
2012/2013,Spain LIGA BBVA,Málaga CF,16,9,13,53,50,57,3
2012/2013,Spain LIGA BBVA,RC Celta de Vigo,10,7,21,37,52,37,-15
2012/2013,Spain LIGA BBVA,RC Deportivo de La Coruña,8,11,19,47,70,35,-23
2012/2013,Spain LIGA BBVA,RCD Espanyol,11,11,16,43,52,44,-9
2012/2013,Spain LIGA BBVA,RCD Mallorca,9,9,20,43,72,36,-29
2012/2013,Spain LIGA BBVA,Rayo Vallecano,16,5,17,50,66,53,-16
2012/2013,Spain LIGA BBVA,Real Betis Balompié,16,8,14,57,56,56,1
2012/2013,Spain LIGA BBVA,Real Madrid CF,26,7,5,103,42,85,61
2012/2013,Spain LIGA BBVA,Real Sociedad,18,12,8,70,49,66,21
2012/2013,Spain LIGA BBVA,Real Valladolid,11,10,17,49,58,43,-9
2012/2013,Spain LIGA BBVA,Real Zaragoza,9,7,22,37,62,34,-25
2012/2013,Spain LIGA BBVA,Sevilla FC,14,8,16,58,54,50,4
2012/2013,Spain LIGA BBVA,Valencia CF,19,8,11,67,54,65,13
2012/2013,Switzerland Super League,BSC Young Boys,11,10,15,48,50,43,-2
2012/2013,Switzerland Super League,FC Basel,21,9,6,61,31,72,30
2012/2013,Switzerland Super League,FC Lausanne-Sports,8,9,19,32,51,33,-19
2012/2013,Switzerland Super League,FC Luzern,10,12,14,41,52,42,-11
2012/2013,Switzerland Super League,FC Sion,13,9,14,40,54,48,-14
2012/2013,Switzerland Super League,FC St. Gallen,17,8,11,54,36,59,18
2012/2013,Switzerland Super League,FC Thun,13,9,14,44,46,48,-2
2012/2013,Switzerland Super League,FC Zürich,16,7,13,62,48,55,14
2012/2013,Switzerland Super League,Grasshopper Club Zürich,20,9,7,48,32,69,16
2012/2013,Switzerland Super League,Servette FC,6,8,22,32,62,26,-30
2013/2014,Belgium Jupiler League,KAA Gent,3,1,2,11,6,10,5
2013/2014,Belgium Jupiler League,KV Oostende,4,2,0,7,1,14,6
2013/2014,Belgium Jupiler League,Lierse SK,2,0,4,5,12,6,-7
2013/2014,Belgium Jupiler League,Waasland-Beveren,1,1,4,7,11,4,-4
2013/2014,England Premier League,Arsenal,24,7,7,68,41,79,27
2013/2014,England Premier League,Aston Villa,10,8,20,39,61,38,-22
2013/2014,England Premier League,Cardiff City,7,9,22,32,74,30,-42
2013/2014,England Premier League,Chelsea,25,7,6,71,27,82,44
2013/2014,England Premier League,Crystal Palace,13,6,19,33,48,45,-15
2013/2014,England Premier League,Everton,21,9,8,61,39,72,22
2013/2014,England Premier League,Fulham,9,5,24,40,85,32,-45
2013/2014,England Premier League,Hull City,10,7,21,38,53,37,-15
2013/2014,England Premier League,Liverpool,26,6,6,101,50,84,51
2013/2014,England Premier League,Manchester City,27,5,6,102,37,86,65
2013/2014,England Premier League,Manchester United,19,7,12,64,43,64,21
2013/2014,England Premier League,Newcastle United,15,4,19,43,59,49,-16
2013/2014,England Premier League,Norwich City,8,9,21,28,62,33,-34
2013/2014,England Premier League,Southampton,15,11,12,54,46,56,8
2013/2014,England Premier League,Stoke City,13,11,14,45,52,50,-7
2013/2014,England Premier League,Sunderland,10,8,20,41,60,38,-19
2013/2014,England Premier League,Swansea City,11,9,18,54,54,42,0
2013/2014,England Premier League,Tottenham Hotspur,21,6,11,55,51,69,4
2013/2014,England Premier League,West Bromwich Albion,7,15,16,43,59,36,-16
2013/2014,England Premier League,West Ham United,11,7,20,40,51,40,-11
2013/2014,France Ligue 1,AC Ajaccio,4,11,23,37,72,23,-35
2013/2014,France Ligue 1,AS Monaco,23,11,4,63,31,80,32
2013/2014,France Ligue 1,AS Saint-Étienne,20,9,9,56,34,69,22
2013/2014,France Ligue 1,En Avant de Guingamp,11,9,18,34,42,42,-8
2013/2014,France Ligue 1,FC Lorient,13,10,15,48,53,49,-5
2013/2014,France Ligue 1,FC Nantes,13,10,15,40,43,49,-3
2013/2014,France Ligue 1,FC Sochaux-Montbéliard,10,10,18,37,61,40,-24
2013/2014,France Ligue 1,Girondins de Bordeaux,13,14,11,49,43,53,6
2013/2014,France Ligue 1,LOSC Lille,20,11,7,46,26,71,20
2013/2014,France Ligue 1,Montpellier Hérault SC,8,18,12,45,53,42,-8
2013/2014,France Ligue 1,OGC Nice,12,6,20,30,44,42,-14
2013/2014,France Ligue 1,Olympique Lyonnais,17,10,11,56,44,61,12
2013/2014,France Ligue 1,Olympique de Marseille,16,12,10,53,40,60,13
2013/2014,France Ligue 1,Paris Saint-Germain,27,8,3,84,23,89,61
2013/2014,France Ligue 1,SC Bastia,12,10,16,42,58,46,-16
2013/2014,France Ligue 1,Stade Rennais FC,11,13,14,47,45,46,2
2013/2014,France Ligue 1,Stade de Reims,12,12,14,44,52,48,-8
2013/2014,France Ligue 1,Toulouse FC,12,13,13,46,53,49,-7
2013/2014,France Ligue 1,Valenciennes FC,7,8,23,37,65,29,-28
2013/2014,France Ligue 1,Évian Thonon Gaillard FC,11,11,16,39,51,44,-12
2013/2014,Germany 1. Bundesliga,1. FC Nürnberg,5,11,18,37,70,26,-33
2013/2014,Germany 1. Bundesliga,1. FSV Mainz 05,16,5,13,52,54,53,-2
2013/2014,Germany 1. Bundesliga,Bayer 04 Leverkusen,19,4,11,60,41,61,19
2013/2014,Germany 1. Bundesliga,Borussia Dortmund,22,5,7,80,38,71,42
2013/2014,Germany 1. Bundesliga,Borussia Mönchengladbach,16,7,11,59,43,55,16
2013/2014,Germany 1. Bundesliga,Eintracht Braunschweig,6,7,21,29,60,25,-31
2013/2014,Germany 1. Bundesliga,Eintracht Frankfurt,9,9,16,40,57,36,-17
2013/2014,Germany 1. Bundesliga,FC Augsburg,15,7,12,47,47,52,0
2013/2014,Germany 1. Bundesliga,FC Bayern Munich,29,3,2,94,23,90,71
2013/2014,Germany 1. Bundesliga,FC Schalke 04,19,7,8,63,43,64,20
2013/2014,Germany 1. Bundesliga,Hamburger SV,7,6,21,51,75,27,-24
2013/2014,Germany 1. Bundesliga,Hannover 96,12,6,16,46,59,42,-13
2013/2014,Germany 1. Bundesliga,Hertha BSC Berlin,11,8,15,40,48,41,-8
2013/2014,Germany 1. Bundesliga,SC Freiburg,9,9,16,43,61,36,-18
2013/2014,Germany 1. Bundesliga,SV Werder Bremen,10,9,15,42,66,39,-24
2013/2014,Germany 1. Bundesliga,TSG 1899 Hoffenheim,11,11,12,72,70,44,2
2013/2014,Germany 1. Bundesliga,VfB Stuttgart,8,8,18,49,62,32,-13
2013/2014,Germany 1. Bundesliga,VfL Wolfsburg,18,6,10,63,50,60,13
2013/2014,Italy Serie A,Atalanta,15,5,18,43,51,50,-8
2013/2014,Italy Serie A,Bologna,5,14,19,28,58,29,-30
2013/2014,Italy Serie A,Cagliari,9,12,17,34,53,39,-19
2013/2014,Italy Serie A,Catania,8,8,22,34,66,32,-32
2013/2014,Italy Serie A,Chievo Verona,10,6,22,34,54,36,-20
2013/2014,Italy Serie A,Fiorentina,19,8,11,65,44,65,21
2013/2014,Italy Serie A,Genoa,11,11,16,41,50,44,-9
2013/2014,Italy Serie A,Hellas Verona,16,6,16,62,68,54,-6
2013/2014,Italy Serie A,Inter,15,15,8,62,39,60,23
2013/2014,Italy Serie A,Juventus,33,3,2,80,23,102,57
2013/2014,Italy Serie A,Lazio,15,11,12,54,54,56,0
2013/2014,Italy Serie A,Livorno,6,7,25,39,77,25,-38
2013/2014,Italy Serie A,Milan,16,9,13,57,49,57,8
2013/2014,Italy Serie A,Napoli,23,9,6,77,39,78,38
2013/2014,Italy Serie A,Parma,15,13,10,58,46,58,12
2013/2014,Italy Serie A,Roma,26,7,5,72,25,85,47
2013/2014,Italy Serie A,Sampdoria,12,9,17,48,62,45,-14
2013/2014,Italy Serie A,Sassuolo,9,7,22,43,72,34,-29
2013/2014,Italy Serie A,Torino,15,12,11,58,48,57,10
2013/2014,Italy Serie A,Udinese,12,8,18,46,57,44,-11
2013/2014,Netherlands Eredivisie,ADO Den Haag,12,7,15,45,64,43,-19
2013/2014,Netherlands Eredivisie,AZ,13,8,13,54,50,47,4
2013/2014,Netherlands Eredivisie,Ajax,20,11,3,69,28,71,41
2013/2014,Netherlands Eredivisie,FC Groningen,14,9,11,57,53,51,4
2013/2014,Netherlands Eredivisie,FC Twente,17,12,5,72,37,63,35
2013/2014,Netherlands Eredivisie,FC Utrecht,11,8,15,46,65,41,-19
2013/2014,Netherlands Eredivisie,Feyenoord,20,7,7,76,40,67,36
2013/2014,Netherlands Eredivisie,Go Ahead Eagles,10,8,16,45,69,38,-24
2013/2014,Netherlands Eredivisie,Heracles Almelo,10,7,17,45,59,37,-14
2013/2014,Netherlands Eredivisie,N.E.C.,5,15,14,54,82,30,-28
2013/2014,Netherlands Eredivisie,NAC Breda,8,11,15,43,54,35,-11
2013/2014,Netherlands Eredivisie,PEC Zwolle,9,13,12,47,49,40,-2
2013/2014,Netherlands Eredivisie,PSV,18,5,11,60,45,59,15
2013/2014,Netherlands Eredivisie,RKC Waalwijk,7,11,16,44,64,32,-20
2013/2014,Netherlands Eredivisie,Roda JC Kerkrade,7,8,19,44,69,29,-25
2013/2014,Netherlands Eredivisie,SC Cambuur,10,9,15,40,50,39,-10
2013/2014,Netherlands Eredivisie,SC Heerenveen,16,9,9,72,51,57,21
2013/2014,Netherlands Eredivisie,Vitesse,15,10,9,65,49,55,16
2013/2014,Poland Ekstraklasa,Cracovia,11,6,13,37,43,39,-6
2013/2014,Poland Ekstraklasa,Jagiellonia Białystok,10,9,11,46,43,39,3
2013/2014,Poland Ekstraklasa,Korona Kielce,9,10,11,36,41,37,-5
2013/2014,Poland Ekstraklasa,Lech Poznań,15,8,7,56,34,53,22
2013/2014,Poland Ekstraklasa,Lechia Gdańsk,10,10,10,38,37,40,1
2013/2014,Poland Ekstraklasa,Legia Warszawa,20,3,7,60,30,63,30
2013/2014,Poland Ekstraklasa,Piast Gliwice,8,10,12,29,47,34,-18
2013/2014,Poland Ekstraklasa,Podbeskidzie Bielsko-Biała,6,13,11,27,39,31,-12
2013/2014,Poland Ekstraklasa,Pogoń Szczecin,11,14,5,47,38,47,9
2013/2014,Poland Ekstraklasa,Polonia Bytom,11,9,10,42,46,42,-4
2013/2014,Poland Ekstraklasa,Ruch Chorzów,14,8,8,40,38,50,2
2013/2014,Poland Ekstraklasa,Widzew Łódź,5,7,18,26,51,22,-25
2013/2014,Poland Ekstraklasa,Wisła Kraków,12,9,9,38,30,45,8
2013/2014,Poland Ekstraklasa,Zagłębie Lubin,7,8,15,31,40,29,-9
2013/2014,Poland Ekstraklasa,Zawisza Bydgoszcz,11,9,10,43,37,42,6
2013/2014,Poland Ekstraklasa,Śląsk Wrocław,7,13,10,38,40,34,-2
2013/2014,Portugal Liga ZON Sagres,Académica de Coimbra,9,10,11,25,35,37,-10
2013/2014,Portugal Liga ZON Sagres,CD Nacional,11,12,7,43,33,45,10
2013/2014,Portugal Liga ZON Sagres,CF Os Belenenses,6,10,14,19,33,28,-14
2013/2014,Portugal Liga ZON Sagres,CS Marítimo,11,8,11,40,44,41,-4
2013/2014,Portugal Liga ZON Sagres,Estoril Praia,15,9,6,42,26,54,16
2013/2014,Portugal Liga ZON Sagres,FC Arouca,8,7,15,28,42,31,-14
2013/2014,Portugal Liga ZON Sagres,FC Paços de Ferreira,6,6,18,28,59,24,-31
2013/2014,Portugal Liga ZON Sagres,FC Porto,19,4,7,57,25,61,32
2013/2014,Portugal Liga ZON Sagres,Gil Vicente FC,8,7,15,23,37,31,-14
2013/2014,Portugal Liga ZON Sagres,Rio Ave FC,8,8,14,21,35,32,-14
2013/2014,Portugal Liga ZON Sagres,S.C. Olhanense,6,6,18,21,49,24,-28
2013/2014,Portugal Liga ZON Sagres,SC Braga,10,7,13,39,37,37,2
2013/2014,Portugal Liga ZON Sagres,SL Benfica,23,5,2,58,18,74,40
2013/2014,Portugal Liga ZON Sagres,Sporting CP,20,7,3,54,20,67,34
2013/2014,Portugal Liga ZON Sagres,Vitória Guimarães,10,5,15,30,35,35,-5
2013/2014,Portugal Liga ZON Sagres,Vitória Setúbal,10,9,11,41,41,39,0
2013/2014,Scotland Premier League,Aberdeen,20,8,10,53,38,68,15
2013/2014,Scotland Premier League,Celtic,31,6,1,102,25,99,77
2013/2014,Scotland Premier League,Dundee United,16,10,12,65,50,58,15
2013/2014,Scotland Premier League,Heart of Midlothian,10,8,20,45,65,38,-20
2013/2014,Scotland Premier League,Hibernian,8,11,19,31,51,35,-20
2013/2014,Scotland Premier League,Inverness Caledonian Thistle,16,9,13,44,44,57,0
2013/2014,Scotland Premier League,Kilmarnock,11,6,21,45,66,39,-21
2013/2014,Scotland Premier League,Motherwell,22,4,12,64,60,70,4
2013/2014,Scotland Premier League,Partick Thistle F.C.,8,14,16,46,65,38,-19
2013/2014,Scotland Premier League,Ross County FC,11,7,20,44,62,40,-18
2013/2014,Scotland Premier League,St. Johnstone FC,15,8,15,48,42,53,6
2013/2014,Scotland Premier League,St. Mirren,10,9,19,39,58,39,-19
2013/2014,Spain LIGA BBVA,Athletic Club de Bilbao,20,10,8,66,39,70,27
2013/2014,Spain LIGA BBVA,Atlético Madrid,28,6,4,77,26,90,51
2013/2014,Spain LIGA BBVA,CA Osasuna,10,9,19,32,62,39,-30
2013/2014,Spain LIGA BBVA,Elche CF,9,13,16,30,50,40,-20
2013/2014,Spain LIGA BBVA,FC Barcelona,27,6,5,100,33,87,67
2013/2014,Spain LIGA BBVA,Getafe CF,11,9,18,35,54,42,-19
2013/2014,Spain LIGA BBVA,Granada CF,12,5,21,32,56,41,-24
2013/2014,Spain LIGA BBVA,Levante UD,12,12,14,35,43,48,-8
2013/2014,Spain LIGA BBVA,Málaga CF,12,9,17,39,46,45,-7
2013/2014,Spain LIGA BBVA,RC Celta de Vigo,14,7,17,49,54,49,-5
2013/2014,Spain LIGA BBVA,RCD Espanyol,11,9,18,41,51,42,-10
2013/2014,Spain LIGA BBVA,Rayo Vallecano,13,4,21,46,80,43,-34
2013/2014,Spain LIGA BBVA,Real Betis Balompié,6,7,25,36,78,25,-42
2013/2014,Spain LIGA BBVA,Real Madrid CF,27,6,5,104,38,87,66
2013/2014,Spain LIGA BBVA,Real Sociedad,16,11,11,62,55,59,7
2013/2014,Spain LIGA BBVA,Real Valladolid,7,15,16,38,60,36,-22
2013/2014,Spain LIGA BBVA,Sevilla FC,18,9,11,69,52,63,17
2013/2014,Spain LIGA BBVA,UD Almería,11,7,20,43,71,40,-28
2013/2014,Spain LIGA BBVA,Valencia CF,13,10,15,51,53,49,-2
2013/2014,Spain LIGA BBVA,Villarreal CF,17,8,13,60,44,59,16
2013/2014,Switzerland Super League,BSC Young Boys,17,8,11,59,50,59,9
2013/2014,Switzerland Super League,FC Aarau,12,6,18,55,71,42,-16
2013/2014,Switzerland Super League,FC Basel,19,15,2,70,34,72,36
2013/2014,Switzerland Super League,FC Lausanne-Sports,7,3,26,38,71,24,-33
2013/2014,Switzerland Super League,FC Luzern,15,6,15,48,54,51,-6
2013/2014,Switzerland Super League,FC Sion,12,7,17,38,45,43,-7
2013/2014,Switzerland Super League,FC St. Gallen,11,12,13,37,47,45,-10
2013/2014,Switzerland Super League,FC Thun,13,9,14,57,53,48,4
2013/2014,Switzerland Super League,FC Zürich,14,8,14,51,52,50,-1
2013/2014,Switzerland Super League,Grasshopper Club Zürich,19,8,9,67,43,65,24
2014/2015,Belgium Jupiler League,Club Brugge KV,17,10,3,69,28,61,41
2014/2015,Belgium Jupiler League,KAA Gent,16,9,5,52,29,57,23
2014/2015,Belgium Jupiler League,KRC Genk,13,10,7,38,28,49,10
2014/2015,Belgium Jupiler League,KSV Cercle Brugge,6,6,18,21,45,24,-24
2014/2015,Belgium Jupiler League,KV Kortrijk,16,3,11,54,35,51,19
2014/2015,Belgium Jupiler League,KV Mechelen,10,11,9,37,39,41,-2
2014/2015,Belgium Jupiler League,KV Oostende,11,5,14,40,52,38,-12
2014/2015,Belgium Jupiler League,KVC Westerlo,8,9,13,42,63,33,-21
2014/2015,Belgium Jupiler League,Lierse SK,5,7,18,30,63,22,-33
2014/2015,Belgium Jupiler League,RSC Anderlecht,16,9,5,51,30,57,21
2014/2015,Belgium Jupiler League,Royal Excel Mouscron,7,5,18,32,51,26,-19
2014/2015,Belgium Jupiler League,SV Zulte-Waregem,8,7,15,41,54,31,-13
2014/2015,Belgium Jupiler League,Sporting Charleroi,14,7,9,44,31,49,13
2014/2015,Belgium Jupiler League,Sporting Lokeren,10,12,8,38,32,42,6
2014/2015,Belgium Jupiler League,Standard de Liège,16,5,9,49,39,53,10
2014/2015,Belgium Jupiler League,Waasland-Beveren,7,5,18,30,49,26,-19
2014/2015,England Premier League,Arsenal,22,9,7,71,36,75,35
2014/2015,England Premier League,Aston Villa,10,8,20,31,57,38,-26
2014/2015,England Premier League,Burnley,7,12,19,28,53,33,-25
2014/2015,England Premier League,Chelsea,26,9,3,73,32,87,41
2014/2015,England Premier League,Crystal Palace,13,9,16,47,51,48,-4
2014/2015,England Premier League,Everton,12,11,15,48,50,47,-2
2014/2015,England Premier League,Hull City,8,11,19,33,51,35,-18
2014/2015,England Premier League,Leicester City,11,8,19,46,55,41,-9
2014/2015,England Premier League,Liverpool,18,8,12,52,48,62,4
2014/2015,England Premier League,Manchester City,24,7,7,83,38,79,45
2014/2015,England Premier League,Manchester United,20,10,8,62,37,70,25
2014/2015,England Premier League,Newcastle United,10,9,19,40,63,39,-23
2014/2015,England Premier League,Queens Park Rangers,8,6,24,42,73,30,-31
2014/2015,England Premier League,Southampton,18,6,14,54,33,60,21
2014/2015,England Premier League,Stoke City,15,9,14,48,45,54,3
2014/2015,England Premier League,Sunderland,7,17,14,31,53,38,-22
2014/2015,England Premier League,Swansea City,16,8,14,46,49,56,-3
2014/2015,England Premier League,Tottenham Hotspur,19,7,12,58,53,64,5
2014/2015,England Premier League,West Bromwich Albion,11,11,16,38,51,44,-13
2014/2015,England Premier League,West Ham United,12,11,15,44,47,47,-3
2014/2015,France Ligue 1,AS Monaco,20,11,7,51,26,71,25
2014/2015,France Ligue 1,AS Saint-Étienne,19,12,7,51,30,69,21
2014/2015,France Ligue 1,En Avant de Guingamp,15,4,19,41,55,49,-14
2014/2015,France Ligue 1,FC Lorient,12,7,19,44,50,43,-6
2014/2015,France Ligue 1,FC Metz,7,9,22,31,61,30,-30
2014/2015,France Ligue 1,FC Nantes,11,12,15,29,40,45,-11
2014/2015,France Ligue 1,Girondins de Bordeaux,17,12,9,47,44,63,3
2014/2015,France Ligue 1,LOSC Lille,16,8,14,43,42,56,1
2014/2015,France Ligue 1,Montpellier Hérault SC,16,8,14,46,39,56,7
2014/2015,France Ligue 1,OGC Nice,13,9,16,44,53,48,-9
2014/2015,France Ligue 1,Olympique Lyonnais,22,9,7,72,33,75,39
2014/2015,France Ligue 1,Olympique de Marseille,21,6,11,76,42,69,34
2014/2015,France Ligue 1,Paris Saint-Germain,24,11,3,83,36,83,47
2014/2015,France Ligue 1,RC Lens,7,8,23,32,61,29,-29
2014/2015,France Ligue 1,SC Bastia,12,11,15,37,46,47,-9
2014/2015,France Ligue 1,SM Caen,12,10,16,54,55,46,-1
2014/2015,France Ligue 1,Stade Rennais FC,13,11,14,35,42,50,-7
2014/2015,France Ligue 1,Stade de Reims,12,8,18,47,66,44,-19
2014/2015,France Ligue 1,Toulouse FC,12,6,20,43,64,42,-21
2014/2015,France Ligue 1,Évian Thonon Gaillard FC,11,4,23,41,62,37,-21
2014/2015,Germany 1. Bundesliga,1. FC Köln,9,13,12,34,40,40,-6
2014/2015,Germany 1. Bundesliga,1. FSV Mainz 05,9,13,12,45,47,40,-2
2014/2015,Germany 1. Bundesliga,Bayer 04 Leverkusen,17,10,7,62,37,61,25
2014/2015,Germany 1. Bundesliga,Borussia Dortmund,13,7,14,47,42,46,5
2014/2015,Germany 1. Bundesliga,Borussia Mönchengladbach,19,9,6,53,26,66,27
2014/2015,Germany 1. Bundesliga,Eintracht Frankfurt,11,10,13,56,62,43,-6
2014/2015,Germany 1. Bundesliga,FC Augsburg,15,4,15,43,43,49,0
2014/2015,Germany 1. Bundesliga,FC Bayern Munich,25,4,5,80,18,79,62
2014/2015,Germany 1. Bundesliga,FC Schalke 04,13,9,12,42,40,48,2
2014/2015,Germany 1. Bundesliga,Hamburger SV,9,8,17,25,50,35,-25
2014/2015,Germany 1. Bundesliga,Hannover 96,9,10,15,40,56,37,-16
2014/2015,Germany 1. Bundesliga,Hertha BSC Berlin,9,8,17,36,52,35,-16
2014/2015,Germany 1. Bundesliga,SC Freiburg,7,13,14,36,47,34,-11
2014/2015,Germany 1. Bundesliga,SC Paderborn 07,7,10,17,31,65,31,-34
2014/2015,Germany 1. Bundesliga,SV Werder Bremen,11,10,13,50,65,43,-15
2014/2015,Germany 1. Bundesliga,TSG 1899 Hoffenheim,12,8,14,49,55,44,-6
2014/2015,Germany 1. Bundesliga,VfB Stuttgart,9,9,16,42,60,36,-18
2014/2015,Germany 1. Bundesliga,VfL Wolfsburg,20,9,5,72,38,69,34
2014/2015,Italy Serie A,Atalanta,7,16,15,38,57,37,-19
2014/2015,Italy Serie A,Cagliari,8,10,20,48,68,34,-20
2014/2015,Italy Serie A,Cesena,4,12,22,36,73,24,-37
2014/2015,Italy Serie A,Chievo Verona,10,13,15,28,41,43,-13
2014/2015,Italy Serie A,Empoli,8,18,12,46,52,42,-6
2014/2015,Italy Serie A,Fiorentina,18,10,10,61,46,64,15
2014/2015,Italy Serie A,Genoa,16,11,11,62,47,59,15
2014/2015,Italy Serie A,Hellas Verona,11,13,14,49,65,46,-16
2014/2015,Italy Serie A,Inter,14,13,11,59,48,55,11
2014/2015,Italy Serie A,Juventus,26,9,3,72,24,87,48
2014/2015,Italy Serie A,Lazio,20,6,11,67,36,66,31
2014/2015,Italy Serie A,Milan,13,13,12,56,50,52,6
2014/2015,Italy Serie A,Napoli,18,9,10,68,50,63,18
2014/2015,Italy Serie A,Palermo,12,13,13,53,55,49,-2
2014/2015,Italy Serie A,Parma,6,8,24,33,75,26,-42
2014/2015,Italy Serie A,Roma,19,13,6,54,31,70,23
2014/2015,Italy Serie A,Sampdoria,13,17,8,48,42,56,6
2014/2015,Italy Serie A,Sassuolo,12,13,13,49,57,49,-8
2014/2015,Italy Serie A,Torino,14,12,12,48,45,54,3
2014/2015,Italy Serie A,Udinese,10,11,17,43,56,41,-13
2014/2015,Netherlands Eredivisie,ADO Den Haag,9,10,15,44,53,37,-9
2014/2015,Netherlands Eredivisie,AZ,19,5,10,63,56,62,7
2014/2015,Netherlands Eredivisie,Ajax,21,8,5,69,29,71,40
2014/2015,Netherlands Eredivisie,Excelsior,6,14,14,47,63,32,-16
2014/2015,Netherlands Eredivisie,FC Dordrecht,4,8,22,24,76,20,-52
2014/2015,Netherlands Eredivisie,FC Groningen,11,13,10,49,53,46,-4
2014/2015,Netherlands Eredivisie,FC Twente,13,10,11,56,51,49,5
2014/2015,Netherlands Eredivisie,FC Utrecht,11,8,15,60,62,41,-2
2014/2015,Netherlands Eredivisie,Feyenoord,17,8,9,56,39,59,17
2014/2015,Netherlands Eredivisie,Go Ahead Eagles,7,6,21,29,59,27,-30
2014/2015,Netherlands Eredivisie,Heracles Almelo,11,4,19,47,64,37,-17
2014/2015,Netherlands Eredivisie,NAC Breda,6,10,18,36,68,28,-32
2014/2015,Netherlands Eredivisie,PEC Zwolle,16,5,13,59,43,53,16
2014/2015,Netherlands Eredivisie,PSV,29,1,4,92,31,88,61
2014/2015,Netherlands Eredivisie,SC Cambuur,11,8,15,46,56,41,-10
2014/2015,Netherlands Eredivisie,SC Heerenveen,13,11,10,53,46,50,7
2014/2015,Netherlands Eredivisie,Vitesse,16,10,8,66,43,58,23
2014/2015,Netherlands Eredivisie,Willem II,13,7,14,46,50,46,-4
2014/2015,Poland Ekstraklasa,Cracovia,10,7,13,35,41,37,-6
2014/2015,Poland Ekstraklasa,GKS Bełchatów,8,7,15,24,42,31,-18
2014/2015,Poland Ekstraklasa,Górnik Łęczna,8,10,12,31,37,34,-6
2014/2015,Poland Ekstraklasa,Jagiellonia Białystok,14,7,9,43,35,49,8
2014/2015,Poland Ekstraklasa,Korona Kielce,10,9,11,34,42,39,-8
2014/2015,Poland Ekstraklasa,Lech Poznań,14,12,4,52,27,54,25
2014/2015,Poland Ekstraklasa,Lechia Gdańsk,11,8,11,36,37,41,-1
2014/2015,Poland Ekstraklasa,Legia Warszawa,17,5,8,57,30,56,27
2014/2015,Poland Ekstraklasa,Piast Gliwice,11,6,13,38,43,39,-5
2014/2015,Poland Ekstraklasa,Podbeskidzie Bielsko-Biała,10,9,11,40,48,39,-8
2014/2015,Poland Ekstraklasa,Pogoń Szczecin,11,8,11,40,38,41,2
2014/2015,Poland Ekstraklasa,Polonia Bytom,11,10,9,43,43,43,0
2014/2015,Poland Ekstraklasa,Ruch Chorzów,8,9,13,33,38,33,-5
2014/2015,Poland Ekstraklasa,Wisła Kraków,11,10,9,47,39,43,8
2014/2015,Poland Ekstraklasa,Zawisza Bydgoszcz,8,5,17,32,52,29,-20
2014/2015,Poland Ekstraklasa,Śląsk Wrocław,12,10,8,43,36,46,7
2014/2015,Portugal Liga ZON Sagres,Académica de Coimbra,4,17,13,26,46,29,-20
2014/2015,Portugal Liga ZON Sagres,Boavista FC,9,7,18,27,50,34,-23
2014/2015,Portugal Liga ZON Sagres,CD Nacional,13,8,13,45,46,47,-1
2014/2015,Portugal Liga ZON Sagres,CF Os Belenenses,12,12,10,34,35,48,-1
2014/2015,Portugal Liga ZON Sagres,CS Marítimo,12,8,14,46,45,44,1
2014/2015,Portugal Liga ZON Sagres,Estoril Praia,9,13,12,38,56,40,-18
2014/2015,Portugal Liga ZON Sagres,FC Arouca,7,7,20,26,50,28,-24
2014/2015,Portugal Liga ZON Sagres,FC Paços de Ferreira,12,11,11,40,45,47,-5
2014/2015,Portugal Liga ZON Sagres,FC Penafiel,5,7,22,29,69,22,-40
2014/2015,Portugal Liga ZON Sagres,FC Porto,25,7,2,74,13,82,61
2014/2015,Portugal Liga ZON Sagres,Gil Vicente FC,4,11,19,25,60,23,-35
2014/2015,Portugal Liga ZON Sagres,Moreirense FC,11,10,13,33,42,43,-9
2014/2015,Portugal Liga ZON Sagres,Rio Ave FC,10,13,11,38,42,43,-4
2014/2015,Portugal Liga ZON Sagres,SC Braga,17,7,10,55,28,58,27
2014/2015,Portugal Liga ZON Sagres,SL Benfica,27,4,3,86,16,85,70
2014/2015,Portugal Liga ZON Sagres,Sporting CP,22,10,2,67,29,76,38
2014/2015,Portugal Liga ZON Sagres,Vitória Guimarães,15,10,9,50,35,55,15
2014/2015,Portugal Liga ZON Sagres,Vitória Setúbal,7,8,19,24,56,29,-32
2014/2015,Scotland Premier League,Aberdeen,23,6,9,57,33,75,24
2014/2015,Scotland Premier League,Celtic,29,5,4,84,17,92,67
2014/2015,Scotland Premier League,Dundee FC,11,12,15,46,57,45,-11
2014/2015,Scotland Premier League,Dundee United,17,5,16,58,56,56,2
2014/2015,Scotland Premier League,Hamilton Academical FC,15,8,15,50,53,53,-3
2014/2015,Scotland Premier League,Inverness Caledonian Thistle,19,8,11,52,42,65,10
2014/2015,Scotland Premier League,Kilmarnock,11,8,19,44,59,41,-15
2014/2015,Scotland Premier League,Motherwell,10,6,22,38,63,36,-25
2014/2015,Scotland Premier League,Partick Thistle F.C.,12,10,16,48,44,46,4
2014/2015,Scotland Premier League,Ross County FC,12,8,18,46,63,44,-17
2014/2015,Scotland Premier League,St. Johnstone FC,16,9,13,34,34,57,0
2014/2015,Scotland Premier League,St. Mirren,9,3,26,30,66,30,-36
2014/2015,Spain LIGA BBVA,Athletic Club de Bilbao,15,10,13,42,41,55,1
2014/2015,Spain LIGA BBVA,Atlético Madrid,23,9,6,67,29,78,38
2014/2015,Spain LIGA BBVA,Córdoba CF,3,11,24,22,68,20,-46
2014/2015,Spain LIGA BBVA,Elche CF,11,8,19,35,62,41,-27
2014/2015,Spain LIGA BBVA,FC Barcelona,30,4,4,110,21,94,89
2014/2015,Spain LIGA BBVA,Getafe CF,10,7,21,33,64,37,-31
2014/2015,Spain LIGA BBVA,Granada CF,7,14,17,29,64,35,-35
2014/2015,Spain LIGA BBVA,Levante UD,9,10,19,34,67,37,-33
2014/2015,Spain LIGA BBVA,Málaga CF,14,8,16,42,48,50,-6
2014/2015,Spain LIGA BBVA,RC Celta de Vigo,13,12,13,47,44,51,3
2014/2015,Spain LIGA BBVA,RC Deportivo de La Coruña,7,14,17,35,60,35,-25
2014/2015,Spain LIGA BBVA,RCD Espanyol,13,10,15,47,51,49,-4
2014/2015,Spain LIGA BBVA,Rayo Vallecano,15,4,19,46,68,49,-22
2014/2015,Spain LIGA BBVA,Real Madrid CF,30,2,6,118,38,92,80
2014/2015,Spain LIGA BBVA,Real Sociedad,11,13,14,44,51,46,-7
2014/2015,Spain LIGA BBVA,SD Eibar,9,8,21,34,55,35,-21
2014/2015,Spain LIGA BBVA,Sevilla FC,23,7,8,71,45,76,26
2014/2015,Spain LIGA BBVA,UD Almería,8,8,22,35,64,32,-29
2014/2015,Spain LIGA BBVA,Valencia CF,22,11,5,70,32,77,38
2014/2015,Spain LIGA BBVA,Villarreal CF,16,12,10,48,37,60,11
2014/2015,Switzerland Super League,BSC Young Boys,19,9,8,64,45,66,19
2014/2015,Switzerland Super League,FC Aarau,6,12,18,31,64,30,-33
2014/2015,Switzerland Super League,FC Basel,24,6,6,84,41,78,43
2014/2015,Switzerland Super League,FC Luzern,12,11,13,54,46,47,8
2014/2015,Switzerland Super League,FC Sion,12,9,15,47,48,45,-1
2014/2015,Switzerland Super League,FC St. Gallen,13,8,15,57,65,47,-8
2014/2015,Switzerland Super League,FC Thun,13,13,10,47,45,52,2
2014/2015,Switzerland Super League,FC Vaduz,7,10,19,28,59,31,-31
2014/2015,Switzerland Super League,FC Zürich,15,8,13,55,48,53,7
2014/2015,Switzerland Super League,Grasshopper Club Zürich,11,10,15,50,56,43,-6
2015/2016,Belgium Jupiler League,Club Brugge KV,21,1,8,64,30,64,34
2015/2016,Belgium Jupiler League,KAA Gent,17,9,4,56,29,60,27
2015/2016,Belgium Jupiler League,KRC Genk,14,6,10,42,30,48,12
2015/2016,Belgium Jupiler League,KV Kortrijk,10,9,11,31,35,39,-4
2015/2016,Belgium Jupiler League,KV Mechelen,10,7,13,48,50,37,-2
2015/2016,Belgium Jupiler League,KV Oostende,14,7,9,55,44,49,11
2015/2016,Belgium Jupiler League,KVC Westerlo,7,9,14,35,59,30,-24
2015/2016,Belgium Jupiler League,Oud-Heverlee Leuven,7,8,15,42,53,29,-11
2015/2016,Belgium Jupiler League,RSC Anderlecht,15,10,5,51,29,55,22
2015/2016,Belgium Jupiler League,Royal Excel Mouscron,7,9,14,39,51,30,-12
2015/2016,Belgium Jupiler League,SV Zulte-Waregem,12,7,11,51,50,43,1
2015/2016,Belgium Jupiler League,Sint-Truidense VV,8,6,16,28,47,30,-19
2015/2016,Belgium Jupiler League,Sporting Charleroi,10,9,11,36,39,39,-3
2015/2016,Belgium Jupiler League,Sporting Lokeren,8,10,12,35,40,34,-5
2015/2016,Belgium Jupiler League,Standard de Liège,12,5,13,41,51,41,-10
2015/2016,Belgium Jupiler League,Waasland-Beveren,9,6,15,40,57,33,-17
2015/2016,England Premier League,Arsenal,20,11,7,65,36,71,29
2015/2016,England Premier League,Aston Villa,3,8,27,27,76,17,-49
2015/2016,England Premier League,Bournemouth,11,9,18,45,67,42,-22
2015/2016,England Premier League,Chelsea,12,14,12,59,53,50,6
2015/2016,England Premier League,Crystal Palace,11,9,18,39,51,42,-12
2015/2016,England Premier League,Everton,11,14,13,59,55,47,4
2015/2016,England Premier League,Leicester City,23,12,3,68,36,81,32
2015/2016,England Premier League,Liverpool,16,12,10,63,50,60,13
2015/2016,England Premier League,Manchester City,19,9,10,71,41,66,30
2015/2016,England Premier League,Manchester United,19,9,10,49,35,66,14
2015/2016,England Premier League,Newcastle United,9,10,19,44,65,37,-21
2015/2016,England Premier League,Norwich City,9,7,22,39,67,34,-28
2015/2016,England Premier League,Southampton,18,9,11,59,41,63,18
2015/2016,England Premier League,Stoke City,14,9,15,41,55,51,-14
2015/2016,England Premier League,Sunderland,9,12,17,48,62,39,-14
2015/2016,England Premier League,Swansea City,12,11,15,42,52,47,-10
2015/2016,England Premier League,Tottenham Hotspur,19,13,6,69,35,70,34
2015/2016,England Premier League,Watford,12,9,17,40,50,45,-10
2015/2016,England Premier League,West Bromwich Albion,10,13,15,34,48,43,-14
2015/2016,England Premier League,West Ham United,16,14,8,65,51,62,14
2015/2016,France Ligue 1,AS Monaco,17,14,7,57,50,65,7
2015/2016,France Ligue 1,AS Saint-Étienne,17,7,14,42,37,58,5
2015/2016,France Ligue 1,Angers SCO,13,11,14,40,38,50,2
2015/2016,France Ligue 1,ES Troyes AC,3,9,26,28,83,18,-55
2015/2016,France Ligue 1,En Avant de Guingamp,11,11,16,47,56,44,-9
2015/2016,France Ligue 1,FC Lorient,11,13,14,47,58,46,-11
2015/2016,France Ligue 1,FC Nantes,12,12,14,33,44,48,-11
2015/2016,France Ligue 1,GFC Ajaccio,8,13,17,37,58,37,-21
2015/2016,France Ligue 1,Girondins de Bordeaux,12,14,12,50,57,50,-7
2015/2016,France Ligue 1,LOSC Lille,15,15,8,39,27,60,12
2015/2016,France Ligue 1,Montpellier Hérault SC,14,7,17,49,47,49,2
2015/2016,France Ligue 1,OGC Nice,18,9,11,58,41,63,17
2015/2016,France Ligue 1,Olympique Lyonnais,19,8,11,67,43,65,24
2015/2016,France Ligue 1,Olympique de Marseille,10,18,10,48,42,48,6
2015/2016,France Ligue 1,Paris Saint-Germain,30,6,2,102,19,96,83
2015/2016,France Ligue 1,SC Bastia,14,8,16,36,42,50,-6
2015/2016,France Ligue 1,SM Caen,16,6,16,39,52,54,-13
2015/2016,France Ligue 1,Stade Rennais FC,13,13,12,52,54,52,-2
2015/2016,France Ligue 1,Stade de Reims,10,9,19,44,57,39,-13
2015/2016,France Ligue 1,Toulouse FC,9,13,16,45,55,40,-10
2015/2016,Germany 1. Bundesliga,1. FC Köln,10,13,11,38,42,43,-4
2015/2016,Germany 1. Bundesliga,1. FSV Mainz 05,14,8,12,46,42,50,4
2015/2016,Germany 1. Bundesliga,Bayer 04 Leverkusen,18,6,10,56,40,60,16
2015/2016,Germany 1. Bundesliga,Borussia Dortmund,24,6,4,82,34,78,48
2015/2016,Germany 1. Bundesliga,Borussia Mönchengladbach,17,4,13,67,50,55,17
2015/2016,Germany 1. Bundesliga,Eintracht Frankfurt,9,9,16,34,52,36,-18
2015/2016,Germany 1. Bundesliga,FC Augsburg,9,11,14,42,52,38,-10
2015/2016,Germany 1. Bundesliga,FC Bayern Munich,28,4,2,80,17,88,63
2015/2016,Germany 1. Bundesliga,FC Ingolstadt 04,10,10,14,33,42,40,-9
2015/2016,Germany 1. Bundesliga,FC Schalke 04,15,7,12,51,49,52,2
2015/2016,Germany 1. Bundesliga,Hamburger SV,11,8,15,40,46,41,-6
2015/2016,Germany 1. Bundesliga,Hannover 96,7,4,23,31,62,25,-31
2015/2016,Germany 1. Bundesliga,Hertha BSC Berlin,14,8,12,42,42,50,0
2015/2016,Germany 1. Bundesliga,SV Darmstadt 98,9,11,14,38,53,38,-15
2015/2016,Germany 1. Bundesliga,SV Werder Bremen,10,8,16,50,65,38,-15
2015/2016,Germany 1. Bundesliga,TSG 1899 Hoffenheim,9,10,15,39,54,37,-15
2015/2016,Germany 1. Bundesliga,VfB Stuttgart,9,6,19,50,75,33,-25
2015/2016,Germany 1. Bundesliga,VfL Wolfsburg,12,9,13,47,49,45,-2
2015/2016,Italy Serie A,Atalanta,11,12,15,41,47,45,-6
2015/2016,Italy Serie A,Bologna,11,9,18,33,45,42,-12
2015/2016,Italy Serie A,Carpi,9,11,18,37,57,38,-20
2015/2016,Italy Serie A,Chievo Verona,13,11,14,43,45,50,-2
2015/2016,Italy Serie A,Empoli,12,10,16,40,49,46,-9
2015/2016,Italy Serie A,Fiorentina,18,10,10,60,42,64,18
2015/2016,Italy Serie A,Frosinone,8,7,23,35,76,31,-41
2015/2016,Italy Serie A,Genoa,13,7,18,45,48,46,-3
2015/2016,Italy Serie A,Hellas Verona,5,13,20,34,63,28,-29
2015/2016,Italy Serie A,Inter,20,7,11,50,38,67,12
2015/2016,Italy Serie A,Juventus,29,4,5,75,20,91,55
2015/2016,Italy Serie A,Lazio,15,9,14,52,52,54,0
2015/2016,Italy Serie A,Milan,15,12,11,49,43,57,6
2015/2016,Italy Serie A,Napoli,25,7,6,80,32,82,48
2015/2016,Italy Serie A,Palermo,10,9,19,38,65,39,-27
2015/2016,Italy Serie A,Roma,23,11,4,83,41,80,42
2015/2016,Italy Serie A,Sampdoria,10,10,18,48,61,40,-13
2015/2016,Italy Serie A,Sassuolo,16,13,9,49,40,61,9
2015/2016,Italy Serie A,Torino,12,9,17,52,55,45,-3
2015/2016,Italy Serie A,Udinese,10,9,19,35,60,39,-25
2015/2016,Netherlands Eredivisie,ADO Den Haag,10,13,11,48,49,43,-1
2015/2016,Netherlands Eredivisie,AZ,18,5,11,70,53,59,17
2015/2016,Netherlands Eredivisie,Ajax,25,7,2,81,21,82,60
2015/2016,Netherlands Eredivisie,De Graafschap,5,8,21,39,66,23,-27
2015/2016,Netherlands Eredivisie,Excelsior,7,9,18,34,60,30,-26
2015/2016,Netherlands Eredivisie,FC Groningen,14,8,12,41,48,50,-7
2015/2016,Netherlands Eredivisie,FC Twente,12,7,15,49,64,43,-15
2015/2016,Netherlands Eredivisie,FC Utrecht,15,8,11,57,48,53,9
2015/2016,Netherlands Eredivisie,Feyenoord,19,6,9,62,40,63,22
2015/2016,Netherlands Eredivisie,Heracles Almelo,14,9,11,47,49,51,-2
2015/2016,Netherlands Eredivisie,N.E.C.,13,7,14,37,42,46,-5
2015/2016,Netherlands Eredivisie,PEC Zwolle,14,6,14,56,54,48,2
2015/2016,Netherlands Eredivisie,PSV,26,6,2,88,32,84,56
2015/2016,Netherlands Eredivisie,Roda JC Kerkrade,8,10,16,34,55,34,-21
2015/2016,Netherlands Eredivisie,SC Cambuur,3,9,22,33,79,18,-46
2015/2016,Netherlands Eredivisie,SC Heerenveen,11,9,14,46,61,42,-15
2015/2016,Netherlands Eredivisie,Vitesse,12,10,12,55,38,46,17
2015/2016,Netherlands Eredivisie,Willem II,6,11,17,35,53,29,-18
2015/2016,Poland Ekstraklasa,Cracovia,12,9,9,57,42,45,15
2015/2016,Poland Ekstraklasa,Górnik Łęczna,8,7,15,30,43,31,-13
2015/2016,Poland Ekstraklasa,Jagiellonia Białystok,10,5,15,37,54,35,-17
2015/2016,Poland Ekstraklasa,Korona Kielce,9,10,11,32,37,37,-5
2015/2016,Poland Ekstraklasa,Lech Poznań,13,4,13,37,38,43,-1
2015/2016,Poland Ekstraklasa,Lechia Gdańsk,10,9,11,45,37,39,8
2015/2016,Poland Ekstraklasa,Legia Warszawa,17,9,4,58,28,60,30
2015/2016,Poland Ekstraklasa,Piast Gliwice,17,7,6,49,36,58,13
2015/2016,Poland Ekstraklasa,Podbeskidzie Bielsko-Biała,9,11,10,37,46,38,-9
2015/2016,Poland Ekstraklasa,Pogoń Szczecin,10,16,4,36,30,46,6
2015/2016,Poland Ekstraklasa,Polonia Bytom,4,14,12,33,46,26,-13
2015/2016,Poland Ekstraklasa,Ruch Chorzów,11,6,13,37,46,39,-9
2015/2016,Poland Ekstraklasa,Termalica Bruk-Bet Nieciecza,8,9,13,33,43,33,-10
2015/2016,Poland Ekstraklasa,Wisła Kraków,8,13,9,45,35,37,10
2015/2016,Poland Ekstraklasa,Zagłębie Lubin,12,9,9,41,37,45,4
2015/2016,Poland Ekstraklasa,Śląsk Wrocław,8,10,12,28,37,34,-9
2015/2016,Portugal Liga ZON Sagres,Académica de Coimbra,5,10,19,32,60,25,-28
2015/2016,Portugal Liga ZON Sagres,Boavista FC,8,9,17,24,41,33,-17
2015/2016,Portugal Liga ZON Sagres,CD Nacional,10,8,16,40,56,38,-16
2015/2016,Portugal Liga ZON Sagres,CF Os Belenenses,10,11,13,44,66,41,-22
2015/2016,Portugal Liga ZON Sagres,CS Marítimo,10,5,19,45,63,35,-18
2015/2016,Portugal Liga ZON Sagres,Estoril Praia,13,8,13,40,41,47,-1
2015/2016,Portugal Liga ZON Sagres,FC Arouca,13,15,6,47,38,54,9
2015/2016,Portugal Liga ZON Sagres,FC Paços de Ferreira,13,10,11,43,42,49,1
2015/2016,Portugal Liga ZON Sagres,FC Porto,23,4,7,67,30,73,37
2015/2016,Portugal Liga ZON Sagres,Moreirense FC,9,9,16,38,54,36,-16
2015/2016,Portugal Liga ZON Sagres,Rio Ave FC,14,8,12,44,44,50,0
2015/2016,Portugal Liga ZON Sagres,SC Braga,16,10,8,54,35,58,19
2015/2016,Portugal Liga ZON Sagres,SL Benfica,29,1,4,88,22,88,66
2015/2016,Portugal Liga ZON Sagres,Sporting CP,27,5,2,79,21,86,58
2015/2016,Portugal Liga ZON Sagres,Tondela,8,6,20,34,54,30,-20
2015/2016,Portugal Liga ZON Sagres,Uniao da Madeira,7,8,19,27,50,29,-23
2015/2016,Portugal Liga ZON Sagres,Vitória Guimarães,9,13,12,45,53,40,-8
2015/2016,Portugal Liga ZON Sagres,Vitória Setúbal,6,12,16,40,61,30,-21
2015/2016,Scotland Premier League,Aberdeen,22,5,11,62,48,71,14
2015/2016,Scotland Premier League,Celtic,26,8,4,93,31,86,62
2015/2016,Scotland Premier League,Dundee FC,11,15,12,53,57,48,-4
2015/2016,Scotland Premier League,Dundee United,8,7,23,45,70,31,-25
2015/2016,Scotland Premier League,Hamilton Academical FC,11,10,17,42,63,43,-21
2015/2016,Scotland Premier League,Heart of Midlothian,18,11,9,59,40,65,19
2015/2016,Scotland Premier League,Inverness Caledonian Thistle,14,10,14,54,48,52,6
2015/2016,Scotland Premier League,Kilmarnock,9,9,20,41,64,36,-23
2015/2016,Scotland Premier League,Motherwell,15,5,18,47,63,50,-16
2015/2016,Scotland Premier League,Partick Thistle F.C.,12,10,16,41,50,46,-9
2015/2016,Scotland Premier League,Ross County FC,14,6,18,55,61,48,-6
2015/2016,Scotland Premier League,St. Johnstone FC,16,8,14,58,55,56,3
2015/2016,Spain LIGA BBVA,Athletic Club de Bilbao,18,8,12,58,45,62,13
2015/2016,Spain LIGA BBVA,Atlético Madrid,28,4,6,63,18,88,45
2015/2016,Spain LIGA BBVA,FC Barcelona,29,4,5,112,29,91,83
2015/2016,Spain LIGA BBVA,Getafe CF,9,9,20,37,67,36,-30
2015/2016,Spain LIGA BBVA,Granada CF,10,9,19,46,69,39,-23
2015/2016,Spain LIGA BBVA,Levante UD,8,8,22,37,70,32,-33
2015/2016,Spain LIGA BBVA,Málaga CF,12,12,14,38,35,48,3
2015/2016,Spain LIGA BBVA,RC Celta de Vigo,17,9,12,51,59,60,-8
2015/2016,Spain LIGA BBVA,RC Deportivo de La Coruña,8,18,12,45,61,42,-16
2015/2016,Spain LIGA BBVA,RCD Espanyol,12,7,19,40,74,43,-34
2015/2016,Spain LIGA BBVA,Rayo Vallecano,9,11,18,52,73,38,-21
2015/2016,Spain LIGA BBVA,Real Betis Balompié,11,12,15,34,52,45,-18
2015/2016,Spain LIGA BBVA,Real Madrid CF,28,6,4,110,34,90,76
2015/2016,Spain LIGA BBVA,Real Sociedad,13,9,16,45,48,48,-3
2015/2016,Spain LIGA BBVA,Real Sporting de Gijón,10,9,19,40,62,39,-22
2015/2016,Spain LIGA BBVA,SD Eibar,11,10,17,49,61,43,-12
2015/2016,Spain LIGA BBVA,Sevilla FC,14,10,14,51,50,52,1
2015/2016,Spain LIGA BBVA,UD Las Palmas,12,8,18,45,53,44,-8
2015/2016,Spain LIGA BBVA,Valencia CF,11,11,16,46,48,44,-2
2015/2016,Spain LIGA BBVA,Villarreal CF,18,10,10,44,35,64,9
2015/2016,Switzerland Super League,BSC Young Boys,20,9,7,78,47,69,31
2015/2016,Switzerland Super League,FC Basel,26,5,5,88,38,83,50
2015/2016,Switzerland Super League,FC Luzern,15,9,12,59,50,54,9
2015/2016,Switzerland Super League,FC Sion,14,8,14,52,49,50,3
2015/2016,Switzerland Super League,FC St. Gallen,10,8,18,41,66,38,-25
2015/2016,Switzerland Super League,FC Thun,10,11,15,45,54,41,-9
2015/2016,Switzerland Super League,FC Vaduz,7,15,14,44,60,36,-16
2015/2016,Switzerland Super League,FC Zürich,7,13,16,48,71,34,-23
2015/2016,Switzerland Super League,Grasshopper Club Zürich,15,8,13,65,56,53,9
2015/2016,Switzerland Super League,Lugano,9,8,19,46,75,35,-29
